artist	genre
"""Da"" Y"	Rick Astley
"""Weird Al"" Yankovic"	Rick Astley
#1 Funny Ringtones for Android Best New Annoying Comedy Parody Alerts Alarms Message Tones Tone Alert & Messages	Rick Astley
009 Sound System	Rick Astley
2WEI	Rick Astley
3 Doors Down	Rick Astley
4th Lyric	Rick Astley
8-Bit Arcade	Rick Astley
:Wumpscut:	Rick Astley
Aaron Lohr	Rick Astley
Adriano Celentano	Rick Astley
Alabama 3	Rick Astley
Alanis Morissette	Rick Astley
Alicia Keys	Rick Astley
Alien Ant Farm	Rick Astley
Anders Nilsen	Rick Astley
Andrea Gibson	Rick Astley
Andrew Rannells	Rick Astley
Anna Kendrick	Rick Astley
Anthony Ramos	Rick Astley
Antoine Dodson	Rick Astley
Antonio Banderas	Rick Astley
Aperture Science Psychoacoustic Laboratories	Rick Astley
April Kelly	Rick Astley
Aqua	Rick Astley
Arrogant Worms	Rick Astley
Arthur Brown	Rick Astley
Aunty Donna	Rick Astley
Austen Tayshus	Rick Astley
Austin Weber	Rick Astley
Austrian Death Machine	Rick Astley
B.E.R.	Rick Astley
Bad Lip Reading	Rick Astley
Barenaked Ladies	Rick Astley
Barry White	Rick Astley
Beairtle Ó Domhnaill	Rick Astley
Bernard Cribbins	Rick Astley
Bill Burr	Rick Astley
Bill Cosby	Rick Astley
Bill Wurtz	Rick Astley
Billy the Fridge	Rick Astley
Birdy Nam Nam	Rick Astley
Biting Elbows	Rick Astley
Biz Markie	Rick Astley
Blonde Redhead	Rick Astley
Bloodhound Gang	Rick Astley
Blue Öyster Cult	Rick Astley
Bo Burnham	Rick Astley
Bobby McFerrin	Rick Astley
Bobby Vinton	Rick Astley
Body Count	Rick Astley
Boggie	Rick Astley
Bon Jovi	Rick Astley
Bondo	Rick Astley
Booker T. & the M.G.'s	Rick Astley
Boosie Badazz	Rick Astley
Brad Paisley	Rick Astley
Brian McKnight	Rick Astley
Bubbles	Rick Astley
Buzzcocks	Rick Astley
CNT	Rick Astley
Canti	Rick Astley
Caramell	Rick Astley
Caravan Palace	Rick Astley
Carl Douglas	Rick Astley
Carly Comando	Rick Astley
Carmen Twillie	Rick Astley
Caroline's Spine	Rick Astley
Cassius Tae	Rick Astley
CeeLo Green	Rick Astley
Chaos Chaos	Rick Astley
Charles Manson	Rick Astley
Cherlene	Rick Astley
Chris Hadfield	Rick Astley
Chris Young	Rick Astley
Christopher Lee	Rick Astley
Christopher Tin	Rick Astley
Chumbawamba	Rick Astley
Clinton Shorter	Rick Astley
Cold Chisel	Rick Astley
College	Rick Astley
Commodores	Rick Astley
Con Bro Chill	Rick Astley
Cookie Monster	Rick Astley
Craig Morgan	Rick Astley
Creature Feature	Rick Astley
Cyranek	Rick Astley
Dale Hawkins	Rick Astley
Dan Bull	Rick Astley
Dan Le Sac vs Scroobius Pip	Rick Astley
Dave Soldier, Komar & Melamid	Rick Astley
David Coffin	Rick Astley
David Cross	Rick Astley
David Hasselhoff	Rick Astley
David Jeremiah	Rick Astley
Dead Or Alive	Rick Astley
Demetri Martin	Rick Astley
Der Tourist	Rick Astley
Dick Dale	Rick Astley
Die Antwoord	Rick Astley
Dieter Goldmann	Rick Astley
Digital Underground	Rick Astley
Disney Studio Chorus	Rick Astley
Disturbed	Rick Astley
Disturbing Tha Peace	Rick Astley
Don McLean	Rick Astley
Donald Glover	Rick Astley
Donald Glover & Danny Pudi	Rick Astley
Doug Stanhope	Rick Astley
Dr. Awkward	Rick Astley
DragonForce	Rick Astley
Drowning Pool	Rick Astley
Duck Sauce	Rick Astley
Dynamite Hack	Rick Astley
E.S. Posthumus	Rick Astley
Eduard Khil	Rick Astley
Edwin Birdsong	Rick Astley
Eiffel 65	Rick Astley
Electric Six	Rick Astley
Ennio Morricone	Rick Astley
Epic Rap Battles of History	Rick Astley
Eric Idle	Rick Astley
Eskmo	Rick Astley
Europe	Rick Astley
Eurythmics	Rick Astley
Evanescence	Rick Astley
FASCINATING AIDA	Rick Astley
Falcone	Rick Astley
Fartbarf	Rick Astley
Fever the Ghost	Rick Astley
Five Finger Death Punch	Rick Astley
Flight of the Conchords	Rick Astley
Flobots	Rick Astley
Flogging Molly	Rick Astley
Fort Minor	Rick Astley
Fountains Of Wayne	Rick Astley
Frankie Goes To Hollywood	Rick Astley
Fred Astaire	Rick Astley
Garfunkel and Oates	Rick Astley
Gary Jules	Rick Astley
Gene Farris	Rick Astley
George Carlin	Rick Astley
George Michael	Rick Astley
George Thorogood & The Destroyers	Rick Astley
Give Zombies the Vote	Rick Astley
Goldie Lookin Chain	Rick Astley
Gordon Lightfoot	Rick Astley
Gotye	Rick Astley
Green Jelly	Rick Astley
Greenskeepers	Rick Astley
Group X - Arabian Rap Sensations	Rick Astley
Guilhem Desq	Rick Astley
Hannibal Buress	Rick Astley
Hans Zimmer	Rick Astley
Hanson	Rick Astley
Harold Rome	Rick Astley
Harry Chapin	Rick Astley
Hechizeros Band	Rick Astley
Heinz Kiessling	Rick Astley
Herb Alpert & The Tijuana Brass	Rick Astley
Hila Ruach	Rick Astley
Hilmar Örn Hilmarsson	Rick Astley
Himmel	Rick Astley
Honeycut	Rick Astley
Hot Action Cop	Rick Astley
Hot Dad	Rick Astley
Howard Shore	Rick Astley
HyunA	Rick Astley
IceJJFish	Rick Astley
Ide the Shanty One	Rick Astley
Illy	Rick Astley
Israel Kamakawiwo'ole	Rick Astley
JG Thirlwell	Rick Astley
Jackie Q	Rick Astley
Jackson Tarricone	Rick Astley
Jakey	Rick Astley
James Blunt	Rick Astley
Jamie Lawson	Rick Astley
Jeff Richmond	Rick Astley
Jemaine Clement	Rick Astley
Jerry Goldsmith	Rick Astley
Jesse Stewart	Rick Astley
Joe Pesci	Rick Astley
John Mulaney	Rick Astley
John Murphy	Rick Astley
Jon Benjamin	Rick Astley
Jon Lajoie	Rick Astley
Jonathan Coulton	Rick Astley
Jonathan Young	Rick Astley
Jonwayne	Rick Astley
Joseph Loduca	Rick Astley
Julie Andrews	Rick Astley
Junior Senior	Rick Astley
Junkie XL	Rick Astley
Justin Kuritzkes	Rick Astley
KNOWER	Rick Astley
Kansas	Rick Astley
Karlheinz Stockhausen	Rick Astley
Kat Flint	Rick Astley
Ken Nordine	Rick Astley
Kenny Loggins	Rick Astley
King Missile	Rick Astley
Klaus Badelt	Rick Astley
Kuana Torres Kahele	Rick Astley
Kyary Pamyu Pamyu	Rick Astley
Kyle Kinane	Rick Astley
Kyu Sakamoto	Rick Astley
LMFAO	Rick Astley
Lemon Demon	Rick Astley
Leo	Rick Astley
Lil Skies	Rick Astley
Limp Bizkit	Rick Astley
Lindemann	Rick Astley
Lispector	Rick Astley
Logan Paul	Rick Astley
London Symphony Orchestra	Rick Astley
Loona	Rick Astley
Louis Cole	Rick Astley
Luke Kelly	Rick Astley
Lustra	Rick Astley
MC Chris	Rick Astley
MINACELENTANO	Rick Astley
Marconi Union	Rick Astley
Mayday	Rick Astley
Melodysheep	Rick Astley
Metro Station	Rick Astley
Miami Nights 1984	Rick Astley
Michael Potts	Rick Astley
Midnight Juggernauts	Rick Astley
Mike Massé	Rick Astley
Mini Swazy	Rick Astley
Mitch Hedberg	Rick Astley
Money Mark	Rick Astley
Monty Python	Rick Astley
Mousse T.	Rick Astley
Movits!	Rick Astley
Mr Weebl	Rick Astley
Murray Gold	Rick Astley
Natalie Venetia Belcon	Rick Astley
New World Sound	Rick Astley
Nickelback	Rick Astley
Nigel Stanford	Rick Astley
Nightime Burnout	Rick Astley
Norm MacDonald	Rick Astley
OK Go	Rick Astley
OMC	Rick Astley
OOMPH!	Rick Astley
OPM	Rick Astley
Odd Mob	Rick Astley
Otherwise	Rick Astley
Papa Roach	Rick Astley
Parry Gripp	Rick Astley
Party All Night	Rick Astley
Patton Oswalt	Rick Astley
Patty Gurdy	Rick Astley
Paul Gilbert	Rick Astley
Paul Kelly	Rick Astley
Paul Stanley	Rick Astley
Paula Abdul	Rick Astley
Peaches	Rick Astley
Peter Auty	Rick Astley
Phil Harris	Rick Astley
Pigeon John	Rick Astley
Pilot	Rick Astley
Pizza Kids	Rick Astley
Playing For Change	Rick Astley
Powerman 5000	Rick Astley
Princ£ Aureliu$	Rick Astley
Priscilla Hernández	Rick Astley
Professor Elemental	Rick Astley
Propellerheads	Rick Astley
Public Service Broadcasting	Rick Astley
Pyongyang Gold Stars	Rick Astley
Q Money	Rick Astley
Queen	Rick Astley
Quiet Riot	Rick Astley
Quindon Tarver	Rick Astley
Raffi	Rick Astley
Rasputina	Rick Astley
Raymond Scott	Rick Astley
Rebecca Black	Rick Astley
Redbone	Rick Astley
Richard Cheese	Rick Astley
Richard Wagner	Rick Astley
Rick Astley	Rick Astley
Rick Moranis	Rick Astley
Rick and Morty	Rick Astley
Rob Zombie	Rick Astley
Robin Williams	Rick Astley
Rockie Gold	Rick Astley
Rockwell	Rick Astley
Rocky Orchestra	Rick Astley
Ronald Jenkees	Rick Astley
Roy Brown	Rick Astley
Rupert Holmes	Rick Astley
Rymdreglage	Rick Astley
SNAP!	Rick Astley
Saliva	Rick Astley
Sam Fonteyn	Rick Astley
Santa Esmeralda	Rick Astley
Sasha, Benny y Erik	Rick Astley
Scatman John	Rick Astley
Scott Joplin	Rick Astley
Seal	Rick Astley
Seth Sentry	Rick Astley
Shawn Bibb	Rick Astley
Shel Silverstein	Rick Astley
Shirley Ellis	Rick Astley
Showbiz & A.G.	Rick Astley
Simple Minds	Rick Astley
Sir Mix-A-Lot	Rick Astley
Slagsmålsklubben	Rick Astley
Southern Culture on the Skids	Rick Astley
Spiderbait	Rick Astley
Spongebob Squarepants	Rick Astley
Stan Bush	Rick Astley
Steel Panther	Rick Astley
Stephanie D'Abruzzo	Rick Astley
Steve Harvey	Rick Astley
Sugababes	Rick Astley
Suicidal Tendencies	Rick Astley
Survivor	Rick Astley
Sébastien Tellier	Rick Astley
Tenacious D	Rick Astley
Thanks, Computer!	Rick Astley
The Andrews Sisters	Rick Astley
The Beards	Rick Astley
The Beautiful South	Rick Astley
The Coasters	Rick Astley
The Collapsable Hearts Club	Rick Astley
The Dubliners	Rick Astley
The Four Lads	Rick Astley
The Fray	Rick Astley
The Gregory Brothers	Rick Astley
The Limousines	Rick Astley
The Lonely Island	Rick Astley
The Pretty Reckless	Rick Astley
The Proclaimers	Rick Astley
The Protomen	Rick Astley
The Ting Tings	Rick Astley
The Top Stoppers	Rick Astley
The Wannadies	Rick Astley
The Weather Girls	Rick Astley
The Wurzels	Rick Astley
Thomas Bergersen	Rick Astley
Thomas Oliver	Rick Astley
Tim Minchin	Rick Astley
Tiny Tim	Rick Astley
Todd Glass	Rick Astley
Tonetta	Rick Astley
Trevor Moore	Rick Astley
Trey Parker	Rick Astley
Tropical Storm	Rick Astley
Troy Bruce	Rick Astley
Vanessa Carlton	Rick Astley
Vitas	Rick Astley
Vladimir Cauchemar	Rick Astley
Waterflame	Rick Astley
Wayne Graham	Rick Astley
Wing	Rick Astley
Wintergatan	Rick Astley
Wolfie's Just Fine	Rick Astley
Woody Allen	Rick Astley
Wyatt Cenac	Rick Astley
YF JR	Rick Astley
Yello	Rick Astley
Ying Yang Twins	Rick Astley
Zack Hemsey	Rick Astley
a-ha	Rick Astley
outsideOUTSIDE	Rick Astley
rathergood.com	Rick Astley
$Ha Hef	retro
3TEETH	retro
Absolute Valentine	retro
Atrium Carceri	retro
Bonggita	retro
Circle of Dust	retro
Dan Terminus	retro
Daniel Deluxe	retro
Dynatron	retro
Endemico	retro
FM-84	retro
Front Line Assembly	retro
Gatekeeper	retro
Gost	retro
Helios	retro
Julian Winding	retro
Laibach	retro
Lazerhawk	retro
Le Matos	retro
Makeup And Vanity Set	retro
Mega Drive	retro
Mitch Murder	retro
Neon Nox	retro
Occams Laser	retro
Pilotpriest	retro
Power Glove	retro
Prick	retro
Robert Parker	retro
Scandroid	retro
ShiBoy	retro
Sinoia Caves	retro
Skinny Puppy	retro
Sleepy Crow	retro
Snog	retro
Timecop1983	retro
Trevor Something	retro
VHS Dreams	retro
Waveshaper	retro
Wice	retro
Zombie Hyperdrive	retro
$teven Cannon	alternative rock
Akira The Don	alternative rock
Ani DiFranco	alternative rock
B.o.B	alternative rock
Babbletron	alternative rock
Baddiel, Skinner & Lightning Seeds	alternative rock
Beautiful Eulogy	alternative rock
Bill Etten & The Heritage Band	alternative rock
Bobby Feeno	alternative rock
Brian Tyler	alternative rock
Bryan Lewis	alternative rock
Captain Ska	alternative rock
David Rovics	alternative rock
Dead Kennedys	alternative rock
Freestyle	alternative rock
Froggy Fresh	alternative rock
Greydon Square	alternative rock
Hillsong UNITED	alternative rock
Hillsong Worship	alternative rock
Italian Stallions	alternative rock
JAMIE WEBSTER	alternative rock
Janis Joplin	alternative rock
John Mellencamp	alternative rock
Josh Garrels	alternative rock
Kate Smith	alternative rock
Kid Rock	alternative rock
Killer Mike	alternative rock
Knife Party	alternative rock
Kwabs	alternative rock
Larry Richardson	alternative rock
Lesley Gore	alternative rock
Lil Boom	alternative rock
Living Colour	alternative rock
Manchester United Boys	alternative rock
Mat Kearney	alternative rock
Merle Haggard	alternative rock
Mike Diva	alternative rock
Netta	alternative rock
Nick Lutsko	alternative rock
Nicky Jam	alternative rock
Ookay	alternative rock
P.E.P.E.	alternative rock
Paul Robeson	alternative rock
Phil Ochs	alternative rock
Prophets Of Rage	alternative rock
Pussy Riot	alternative rock
Rage Against The Machine	alternative rock
Rucka Rucka Ali	alternative rock
Rusty Cage	alternative rock
Semisonic	alternative rock
Skunk Anansie	alternative rock
Stray From The Path	alternative rock
Sycamore	alternative rock
Tantric	alternative rock
The Coup	alternative rock
The Outfield	alternative rock
Tim Heidecker	alternative rock
Trick Trick	alternative rock
Utah Phillips	alternative rock
Victor Oladipo	alternative rock
ZSK	alternative rock
$uicideBoy$	rap2
03 Greedo	rap2
070 Shake	rap2
2 Chainz	rap2
21 Savage	rap2
6 Dogs	rap2
6LACK	rap2
88GLAM	rap2
A Boogie Wit da Hoodie	rap2
A$AP Ferg	rap2
A$AP Twelvyy	rap2
A-Trak	rap2
A.CHAL	rap2
AZ	rap2
Ab-Soul	rap2
Afu-Ra	rap2
Ameer Vann	rap2
Amir Obe	rap2
Antwon	rap2
Apollo Brown	rap2
Avantdale Bowling Club	rap2
Azizi Gibson	rap2
BJ The Chicago Kid	rap2
Baka Not Nice	rap2
Bas	rap2
Beanie Sigel	rap2
Belly	rap2
Berhana	rap2
Big Boi	rap2
Big K.R.I.T.	rap2
Big Tymers	rap2
Billy Currington	rap2
Billy Lemos	rap2
Black Hippy	rap2
Black Milk	rap2
Black Thought	rap2
Blahzay Blahzay	rap2
Boogie	rap2
Brain	rap2
Buddy	rap2
Bun B	rap2
CZARFACE	rap2
Cal Chuchesta	rap2
Camp Lo	rap2
Camu Tao	rap2
Cam’ron	rap2
Carnage	rap2
Casey Veggies	rap2
Charles Hamilton	rap2
Chester Watson	rap2
Chief Keef	rap2
Choker	rap2
City Morgue	rap2
Clipse	rap2
Comethazine	rap2
Cousin Stizz	rap2
Creek Boyz	rap2
Curren$y	rap2
Curren$y & Alchemist	rap2
CyHi The Prynce	rap2
DJ Muggs	rap2
DJ Quik	rap2
Danger Incorporated	rap2
Darq E Freaker	rap2
Dave	rap2
Dave East	rap2
Dela	rap2
Denzel Curry	rap2
Dizzy Wright	rap2
Domo Genesis	rap2
Don Toliver	rap2
Dowsing	rap2
Dr. Yen Lo	rap2
Duckwrth	rap2
EARTHGANG	rap2
Eearz	rap2
Elyahu	rap2
Everything Is Recorded	rap2
Evidence	rap2
Fabolous	rap2
Fagan	rap2
Famous Dex	rap2
Felly	rap2
Flatbush Zombies	rap2
Freddie Gibbs	rap2
Freestyle Fellowship	rap2
Freeway	rap2
Future	rap2
GV	rap2
Gangsta Pat	rap2
Geo47	rap2
Ghostface Killah	rap2
GoldLink	rap2
Goldstepz	rap2
Goodie Mob	rap2
Gucci Mane	rap2
Gunna	rap2
HS87	rap2
Heltah Skeltah	rap2
Hermit and the Recluse	rap2
Huncho Jack	rap2
IAMDDB	rap2
IDK	rap2
ILOVEMAKONNEN	rap2
Illa J	rap2
Injury Reserve	rap2
Isaiah Rashad	rap2
J Hus	rap2
J.K. The Reaper	rap2
JID	rap2
Jack Harlow	rap2
Jakman	rap2
Jam Baxter	rap2
Jase Harley	rap2
Jay Critch	rap2
Jay Prince	rap2
Jay Rock	rap2
Jazz Cartier	rap2
Jeezy	rap2
Jeremiah Jae	rap2
Jerry Rozz	rap2
Jeru The Damaja	rap2
Jim Jones	rap2
Joe Walsh	rap2
Joey Bada$$	rap2
Joey Purp	rap2
Judson Wright	rap2
Juelz Santana	rap2
Juliano	rap2
K.A.A.N.	rap2
KIDS SEE GHOSTS	rap2
KILLY	rap2
KISSTHECROOK	rap2
KMD	rap2
Ka	rap2
Kap G	rap2
Kemba	rap2
Kenny Loften	rap2
Kevin Gates	rap2
King Geedorah	rap2
Knxwledge	rap2
Kodak Black	rap2
LUCKI	rap2
Lance Skiiiwalker	rap2
Lander B	rap2
Liam Hayes	rap2
Like	rap2
Lil Baby	rap2
Lil Mosey	rap2
Lil Peep	rap2
Lil Ugly Mane	rap2
Lil Uzi Vert	rap2
Lil Yachty	rap2
Little Simz	rap2
Lucki Eck$	rap2
MIKE	rap2
Mac Miller	rap2
MadeinTYO	rap2
Majid Jordan	rap2
Marlowe	rap2
Masta Ace	rap2
Maxo Kream	rap2
Meek Mill	rap2
MellowHype	rap2
Method Man	rap2
Metro Boomin	rap2
Mick Jenkins	rap2
Mike WiLL Made-It	rap2
Montana of 300	rap2
Mr Hudson	rap2
Mr. Muthafuckin' eXquire	rap2
Murs	rap2
Mustard	rap2
NAV	rap2
NNAMDÏ	rap2
Nef The Pharaoh	rap2
Nipsey Hussle	rap2
NxWorries	rap2
Oliver Francis	rap2
Orca Falls	rap2
Organized Konfusion	rap2
PARTYNEXTDOOR	rap2
PRO ERA	rap2
PRhyme	rap2
Pastor T.L. Barrett	rap2
Paul Wall	rap2
Pell	rap2
Pete Rock	rap2
Pimp C	rap2
Playboi Carti	rap2
Pouya	rap2
Pressa	rap2
Pusha T	rap2
Q-Tip	rap2
Qartel	rap2
Quality Control	rap2
Quavo	rap2
R.A. The Rugged Man	rap2
Raekwon	rap2
Rakim	rap2
Ramirez	rap2
Rapsody	rap2
Ras Kass	rap2
Rejjie Snow	rap2
Retch	rap2
Rich The Kid	rap2
Rick Ross	rap2
Rico Nasty	rap2
Roc Marciano	rap2
Roy Woods	rap2
"Royce Da 5'9"""	rap2
SAINt JHN	rap2
SOB X RBE	rap2
Saba	rap2
SahBabii	rap2
Sango	rap2
Scarlxrd	rap2
Sean Price	rap2
Sean Will	rap2
SiR	rap2
Silk Animus	rap2
Ski Mask The Slump God	rap2
Slim Thug	rap2
Slum Village	rap2
Smif-N-Wessun	rap2
Smino	rap2
Smokepurpp	rap2
Sole	rap2
Sonder	rap2
SpaceGhostPurrp	rap2
Statik Selektah	rap2
Strong Arm Steady	rap2
Styles Of Beyond	rap2
Sunrey	rap2
Swizz Beatz	rap2
Sybyr	rap2
Sylvan LaCue	rap2
Symere Woods	rap2
TIL ALL IS ONE	rap2
Takeoff	rap2
Talib Kweli	rap2
Tay-K	rap2
Taylor Bennett	rap2
Tee Grizzley	rap2
Teo	rap2
Terrace Martin	rap2
Teyana Taylor	rap2
Thankyou	rap2
The Alchemist	rap2
The Diplomats	rap2
The Foreign Exchange	rap2
The Masons	rap2
The Underachievers	rap2
Thouxanbanfauni	rap2
Three 6 Mafia	rap2
Thutmose	rap2
Tiny Meat Gang	rap2
Tommy Genesis	rap2
Topaz Jones	rap2
Tory Lanez	rap2
Trae Tha Truth	rap2
Travis Scott	rap2
Trippie Redd	rap2
Ty Dolla $ign	rap2
UGLYFRANK	rap2
Viktor Vaughn	rap2
Wale	rap2
Westside Gunn	rap2
Wifisfuneral	rap2
Wiki	rap2
Wiz Khalifa	rap2
WizKid	rap2
XO	rap2
Xzibit	rap2
YBN Cordae	rap2
YBN Nahmir	rap2
YGTUT	rap2
YOTA : Youth of the Apocalypse	rap2
Young Buck	rap2
Young Dolph	rap2
Young Nudy	rap2
Young Pappy	rap2
Young Thug	rap2
Young Thugga	rap2
YoungBoy Never Broke Again	rap2
Your Old Droog	rap2
Yung Bans	rap2
Zaytoven	rap2
Zelooperz	rap2
Zion I	rap2
billy woods	rap2
'68	poppunk
45 Grave	poppunk
Aaron West and The Roaring Twenties	poppunk
Against Me!	poppunk
Alkaline Trio	poppunk
All Time Low	poppunk
Anthony Green	poppunk
Anti-Flag	poppunk
Army Of The Pharaohs	poppunk
At The Drive In	poppunk
BBQ Chickens	poppunk
Bad Brains	poppunk
Bayside	poppunk
Bikini Kill	poppunk
Bill Conti	poppunk
Black Lips	poppunk
Boysetsfire	poppunk
Brand New	poppunk
Cap'n Jazz	poppunk
Circa Survive	poppunk
Clowns	poppunk
Coil	poppunk
Creeper	poppunk
Current 93	poppunk
D.O.A.	poppunk
DON BROCO	poppunk
Days N Daze	poppunk
Dead Can Dance	poppunk
Desaparecidos	poppunk
Descendents	poppunk
Dollar Signs	poppunk
Drive Like Jehu	poppunk
Dune Rats	poppunk
E.S.G.	poppunk
Enter Shikari	poppunk
Ezra Furman	poppunk
FIDLAR	poppunk
Fenix TX	poppunk
Foreign Legion	poppunk
From First To Last	poppunk
Front Porch Step	poppunk
Gallows	poppunk
Garland Jeffreys	poppunk
HalfNoise	poppunk
Harley Poe	poppunk
Hawthorne Heights	poppunk
Hrvrd	poppunk
Hüsker Dü	poppunk
IDLES	poppunk
Innocent	poppunk
Jawbreaker	poppunk
La Dispute	poppunk
Lincoln	poppunk
Millencolin	poppunk
Minutemen	poppunk
Modern Baseball	poppunk
Motion City Soundtrack	poppunk
Moving Mountains	poppunk
Off With Their Heads	poppunk
Os Alice	poppunk
Osker	poppunk
Overplay	poppunk
PUP	poppunk
Pansy Division	poppunk
Pat The Bunny	poppunk
Pkew Pkew Pkew	poppunk
Q And Not U	poppunk
Quicksand	poppunk
Radkey	poppunk
Reggie And The Full Effect	poppunk
Rites of Spring	poppunk
Rocket From The Tombs	poppunk
Saetia	poppunk
Say Anything	poppunk
Sergio Dalma	poppunk
Sex Pistols	poppunk
Slaves	poppunk
Sloppy Seconds	poppunk
Something Corporate	poppunk
Sum 41	poppunk
Sunny Day Real Estate	poppunk
Sunrise Skater Kids	poppunk
Sweet Jonny	poppunk
Taking Back Sunday	poppunk
Team Dresch	poppunk
Teenage Bottlerocket	poppunk
The Appleseed Cast	poppunk
The Early November	poppunk
The Fall of Troy	poppunk
The Flatliners	poppunk
The Front Bottoms	poppunk
The Get Up Kids	poppunk
The Gun Club	poppunk
The Haxan Cloak	poppunk
The Interrupters	poppunk
The Jesus Lizard	poppunk
The Lawrence Arms	poppunk
The Maine	poppunk
The Menzingers	poppunk
The Only Ones	poppunk
The Orphans	poppunk
The Queers	poppunk
The Soft Moon	poppunk
The Stooges	poppunk
The Taxpayers	poppunk
The Used	poppunk
Thee Minks	poppunk
Thrice	poppunk
Title Fight	poppunk
Tonight Alive	poppunk
Trophy Scars	poppunk
Turnover	poppunk
Wipers	poppunk
Wire	poppunk
X-Ray Spex	poppunk
Yellowcard	poppunk
Yoni Saffra	poppunk
blink-182	poppunk
boris smile	poppunk
(G)I-DLE	k-pop2
2NE1	k-pop2
AKMU	k-pop2
AOA	k-pop2
Adrian Kwiatkowski	k-pop2
Agust D	k-pop2
BIGBANG	k-pop2
BLACKPINK	k-pop2
BOBBY	k-pop2
BTS	k-pop2
BgA	k-pop2
Brown Eyed Girls	k-pop2
CL	k-pop2
Crayon Pop	k-pop2
DEAN	k-pop2
DPR LIVE	k-pop2
Doughboyz Cashout	k-pop2
EXID	k-pop2
EXO	k-pop2
Epik High	k-pop2
FIESTAR	k-pop2
Far East Movement	k-pop2
Fei	k-pop2
Frenzal Rhomb	k-pop2
G-DRAGON	k-pop2
GOT7	k-pop2
Girl's Day	k-pop2
Girls' Generation	k-pop2
HEIZE	k-pop2
HYUKOH	k-pop2
ILL Bill	k-pop2
IU	k-pop2
IZ*ONE	k-pop2
Jay Park	k-pop2
KARD	k-pop2
LEE HI	k-pop2
LOONA	k-pop2
LUNA	k-pop2
Lim Kim	k-pop2
MOMOLAND	k-pop2
NCT	k-pop2
Orange Caramel	k-pop2
PENTAGON	k-pop2
Primary	k-pop2
RM	k-pop2
Rainbow	k-pop2
Red Velvet	k-pop2
Rudovsky	k-pop2
SEUNGRI	k-pop2
SISTAR	k-pop2
SUNMI	k-pop2
Stellar	k-pop2
T-ara	k-pop2
TAEYANG	k-pop2
TAEYEON	k-pop2
TWICE	k-pop2
Trouble Maker	k-pop2
Twinkle Twinkle Little Rock Star	k-pop2
Wonder Girls	k-pop2
Yubin	k-pop2
Zion.T	k-pop2
f(x)	k-pop2
j-hope	k-pop2
miss A	k-pop2
offonoff	k-pop2
이달의 소녀 yyxy	k-pop2
(Sandy) Alex G	indie
A Sunny Day In Glasgow	indie
ANOHNI	indie
Adrianne Lenker	indie
Adult Jazz	indie
Albert Hammond, Jr.	indie
Algiers	indie
All We Are	indie
Andy Shauf	indie
Anna Calvi	indie
Another Sunny Day	indie
Bad Sounds	indie
Bass Drum of Death	indie
Beach Slang	indie
Beat Happening	indie
Benjamin Clementine	indie
Big Thief	indie
Black Honey	indie
Blood Orange	indie
Boy Harsher	indie
Bully	indie
Cameron Avery	indie
Cass McCombs	indie
Chad VanGaalen	indie
Charlotte Gainsbourg	indie
Charly Bliss	indie
Chastity Belt	indie
Cherry Glazerr	indie
Clarence Clarity	indie
Cloakroom	indie
Cloud Nothings	indie
Colleen Green	indie
Computer Magic	indie
Conor Oberst	indie
Craig Finn	indie
Criminal Damage	indie
Crumb	indie
Cults	indie
Culture Abuse	indie
D.D Dumbo	indie
Dan Auerbach	indie
Deakin	indie
Dean Blunt	indie
Deerhoof	indie
Destroyer	indie
Diet Cig	indie
Disco Inferno	indie
Drab Majesty	indie
Drop Nineteens	indie
Drugdealer	indie
Ducktails	indie
Elbow	indie
Emperor X	indie
Estrons	indie
Field Medic	indie
Flyying Colours	indie
Forth Wanderers	indie
Foxing	indie
Frankie Cosmos	indie
Frankie Rose	indie
Fucked Up	indie
GUM	indie
Girl Band	indie
Glue Trip	indie
Good Morning	indie
Guerilla Toss	indie
HAERTS	indie
Haley Heynderickx	indie
Hatchie	indie
Hazel English	indie
Her's	indie
Here We Go Magic	indie
Hinds	indie
Holy Holy	indie
Hookworms	indie
Hoops	indie
Hop Along	indie
Iceage	indie
Jagwar Ma	indie
Jam 'n' Slate	indie
James McAlister	indie
Jay Som	indie
Jeff Rosenstock	indie
Jenny Hval	indie
Jesca Hoop	indie
John Maus	indie
Julia Holter	indie
Julia Jacklin	indie
Julie Byrne	indie
Julien Baker	indie
Kakkmaddafakka	indie
Kevin Morby	indie
Kikagaku Moyo	indie
King Tuff	indie
Klangstof	indie
Kyle Craft	indie
Lambchop	indie
Laura Marling	indie
Let's Eat Grandma	indie
Liam Gallagher	indie
Life Without Buildings	indie
Liza Anne	indie
Lost Under Heaven	indie
Lucy Dacus	indie
Margaret Glaspy	indie
Margo Price	indie
Marika Hackman	indie
Marissa Nadler	indie
Martha	indie
Meatbodies	indie
Men I Trust	indie
Methyl Ethel	indie
Metz	indie
Miles Kane	indie
Mimicking Birds	indie
Mini Mansions	indie
Mink Mussel Creek	indie
Minor Victories	indie
Mission Of Burma	indie
Moon Duo	indie
MorMor	indie
Morgan Delt	indie
Moses Sumney	indie
Mothers	indie
Mr. Husband	indie
Mutual Benefit	indie
Natalie Prass	indie
Netherfriends	indie
Nick Hakim	indie
Nick Murphy	indie
Night Moves	indie
Noel Gallagher's High Flying Birds	indie
Nothing	indie
Omni	indie
Ought	indie
Ovlov	indie
POLIÇA	indie
PWR BTTM	indie
Palace	indie
Palm	indie
Paper Route	indie
Parquet Courts	indie
Patrick Watson	indie
Pedro The Lion	indie
Peter Silberman	indie
Phoebe Bridgers	indie
Pia Fraus	indie
Pinegrove	indie
Pinkshinyultrablast	indie
Porches	indie
Post Animal	indie
Preoccupations	indie
Priests	indie
Protomartyr	indie
Richard Dawson	indie
Richard Edwards	indie
Rivers Cuomo	indie
Rolling Blackouts Coastal Fever	indie
Ron Gallo	indie
Rostam	indie
Rozwell Kid	indie
SWMRS	indie
Saintseneca	indie
Say Sue Me	indie
Shame	indie
Shearwater	indie
Sheer Mag	indie
Skywave	indie
Slothrust	indie
Snail Mail	indie
Soccer Mommy	indie
Social Norms	indie
Son Lux	indie
Still Corners	indie
Street Sects	indie
Sugar Candy Mountain	indie
Summer Salt	indie
Sunflower Bean	indie
Superorganism	indie
Surf Curse	indie
Suuns	indie
TOPS	indie
TORRES	indie
Tanukichan	indie
Teen Suicide	indie
Teenage Wrist	indie
The Beths	indie
The Big Moon	indie
The Bunny Tylers	indie
The Buttertones	indie
The Classless	indie
The Dodos	indie
The Field Mice	indie
The Greeting Committee	indie
The Holydrug Couple	indie
The Horrors	indie
The Lemon Twigs	indie
The Murlocs	indie
The Radio Dept.	indie
The Smith Street Band	indie
The Voidz	indie
The World Is A Beautiful Place & I Am No Longer Afraid To Die	indie
Tokyo Police Club	indie
Tom Rosenthal	indie
Tropical Fuck Storm	indie
Twin Peaks	indie
Ty Segall	indie
U.S. Girls	indie
Unwound	indie
Vancouver Sleep Clinic	indie
Viagra Boys	indie
Vundabar	indie
Waxahatchee	indie
We Are Scientists	indie
Weyes Blood	indie
White Lung	indie
White Reaper	indie
Whitney	indie
Wild Nothing	indie
Women	indie
Woods	indie
Yellow Days	indie
Yumi Zouma	indie
Yves Tumor	indie
Zola Jesus	indie
serpentwithfeet	indie
⣎⡇ꉺლ༽இ•̛)ྀ◞ ༎ຶ ༽ৣৢ؞ৢ؞ؖ ꉺლ	indie
*NSYNC	famous rock
A Flock Of Seagulls	famous rock
A Great Big World	famous rock
ABBA	famous rock
ASIAN KUNG-FU GENERATION	famous rock
AWOLNATION	famous rock
Ace Hood	famous rock
Adam Lambert	famous rock
Adele	famous rock
Adrian Von Ziegler	famous rock
Adventure Time	famous rock
Aerosmith	famous rock
Alice Merton	famous rock
All That Jazz	famous rock
Alphaville	famous rock
Andrew Gold	famous rock
Andrew W.K.	famous rock
Anthony Rapp	famous rock
Apartje.	famous rock
Area 11	famous rock
Asher Roth	famous rock
Auli'i Cravalho	famous rock
Aviators	famous rock
Bag Raiders	famous rock
Baha Men	famous rock
Baltic House Orchestra	famous rock
Basshunter	famous rock
Battle Tapes	famous rock
Ben Platt	famous rock
Bette Midler	famous rock
Big Shaq	famous rock
Bob's Burgers	famous rock
Bonnie Tyler	famous rock
Boyz II Men	famous rock
Brody Dalle	famous rock
Bruno Mars	famous rock
C418	famous rock
Catherine Zeta-Jones	famous rock
CeCe Peniston	famous rock
Christopher Jackson	famous rock
Chubby Checker	famous rock
Combichrist	famous rock
Crash and the Boys	famous rock
Crazy Ex-Girlfriend Cast	famous rock
Creed	famous rock
Cœur De Pirate	famous rock
DEVO	famous rock
DJ Blyatman	famous rock
DJ Khaled	famous rock
DMX	famous rock
Daveed Diggs	famous rock
David Glen Eisley	famous rock
Deeper Purpose	famous rock
Depraved Prophets	famous rock
Doja Cat	famous rock
Donny Osmond	famous rock
Dropkick Murphys	famous rock
Dwayne Johnson	famous rock
Dytrip	famous rock
Earth, Wind & Fire	famous rock
Elton Britt	famous rock
Entheos	famous rock
Eve	famous rock
Faith Hill	famous rock
Fall Out Boy	famous rock
Fear, and Loathing in Las Vegas	famous rock
Firebreather	famous rock
Flaaurs	famous rock
FlyByNo	famous rock
Forge	famous rock
G.L.O.S.S.	famous rock
Ginuwine	famous rock
Gloria Gaynor	famous rock
Gmcfosho	famous rock
Gogol Bordello	famous rock
Gopnik McBlyat	famous rock
Grant Macdonald	famous rock
Grover Washington, Jr.	famous rock
Haddaway	famous rock
Halestorm	famous rock
Halogen	famous rock
HammerFall	famous rock
Hard Bass School	famous rock
Hari Kondabolu	famous rock
Hikaru Utada	famous rock
House Of Pain	famous rock
Hovey Benjamin	famous rock
Hugh Jackman	famous rock
Iamjakehill	famous rock
Ian Taylor	famous rock
Ice Cube	famous rock
Imagine Dragons	famous rock
In Love With a Ghost	famous rock
Infernal	famous rock
Iyaz	famous rock
Ja Rule	famous rock
Jake Paul	famous rock
James Hannigan	famous rock
Jamie Christopherson	famous rock
Jan Dismas Zelenka	famous rock
Jaroslav Beck	famous rock
Jeff Williams	famous rock
Jeremy Irons	famous rock
Jeremy Zuckerman	famous rock
Jesse Novak	famous rock
Jesu	famous rock
John Powell	famous rock
Jojo	famous rock
Jon Brion	famous rock
Jonathan Groff	famous rock
Journey	famous rock
Justin Bieber	famous rock
Katy Perry	famous rock
Kay Kyser & His Orchestra	famous rock
Keith Ape	famous rock
Keith Power	famous rock
Kiesza	famous rock
Kirin J Callinan	famous rock
Koethe	famous rock
Kool & The Gang	famous rock
L'Orchestra Cinematique	famous rock
LADYBABY	famous rock
LL Cool J	famous rock
LOMIS	famous rock
La La Land Cast	famous rock
Lady	famous rock
Le Castle Vania	famous rock
LeAnn Rimes	famous rock
League of Legends	famous rock
Les Misérables - 10th Anniversary Concert Cast	famous rock
Les Trois Accords	famous rock
Leslie Odom Jr.	famous rock
Lil Broomstick	famous rock
Lil Scrappy	famous rock
Lin-Manuel Miranda	famous rock
Linkin Park	famous rock
Lionel Richie	famous rock
Little Texas	famous rock
Loreen	famous rock
Lou Bega	famous rock
Lou Monte	famous rock
Louis Armstrong	famous rock
Luniz	famous rock
Lynyrd Skynyrd	famous rock
M3NYFAC3Z	famous rock
MC No Limit	famous rock
Macho Man Randy Savage	famous rock
Macklemore & Ryan Lewis	famous rock
Mackned	famous rock
Mariachi Vargas De Tecalitlan	famous rock
Marty Robbins	famous rock
Marvin Gaye	famous rock
Matisyahu	famous rock
Meat Loaf	famous rock
Megan Thee Stallion	famous rock
Men At Work	famous rock
Miracle Of Sound	famous rock
Monster Truck	famous rock
Motohiro Hata	famous rock
Mr. Garrison, The 3rd Grade Teacher	famous rock
Mree	famous rock
Mystery Skulls	famous rock
Mötley Crüe	famous rock
Nathan Lane	famous rock
Network Music Ensemble	famous rock
Ninja Sex Party	famous rock
Noisestorm	famous rock
Nostromo Pilots	famous rock
OMFG	famous rock
ONE OK ROCK	famous rock
Original Broadway Cast of Hamilton	famous rock
PUSHER TON	famous rock
Paradox Interactive	famous rock
Paul Engemann	famous rock
Pennywise	famous rock
Pentakill	famous rock
Pharrell Williams	famous rock
Phillipa Soo	famous rock
Pink Ball	famous rock
Pink Guy	famous rock
Pitbull	famous rock
Player	famous rock
Pokémon	famous rock
Pretty Vicious	famous rock
Puffy AmiYumi	famous rock
Quad City DJ's	famous rock
Rag'n'Bone Man	famous rock
Rammstein	famous rock
Randy Newman	famous rock
Rayzd	famous rock
Robbie Williams	famous rock
Ryan Gosling	famous rock
S3RL	famous rock
SIAMES	famous rock
Sabaton	famous rock
Sam Sparro	famous rock
Sarah McLachlan	famous rock
Savvy Kray	famous rock
Scooter	famous rock
Scorpions	famous rock
Scratch21	famous rock
Shania Twain	famous rock
Shokk	famous rock
Simon & Garfunkel	famous rock
Simple Plan	famous rock
Skillet	famous rock
Skyhill	famous rock
Smash Mouth	famous rock
Snail's House	famous rock
Stephen Sondheim	famous rock
Steve Miller Band	famous rock
Steven Universe	famous rock
Stompin' Tom Connors	famous rock
Studio Killers	famous rock
Syd Matters	famous rock
TOTO	famous rock
TTNG	famous rock
TWRP	famous rock
Tegan and Sara	famous rock
Teriyaki Boyz	famous rock
TerribleTim	famous rock
The B-52's	famous rock
The Background Musicians	famous rock
The Blasting Company	famous rock
The Brotet	famous rock
The Children Of Sunshine	famous rock
The Chordettes	famous rock
The Clash	famous rock
The Fratellis	famous rock
The HU	famous rock
The Living Tombstone	famous rock
The Mighty Mighty Bosstones	famous rock
The O'Jays	famous rock
The Pointer Sisters	famous rock
The Red Army Choir	famous rock
The Revels	famous rock
The Score	famous rock
The Tokens	famous rock
The Vapors	famous rock
The Wiggles	famous rock
The Yogscast	famous rock
Therein	famous rock
Thin Lizzy	famous rock
Three Days Grace	famous rock
Three Dog Night	famous rock
Tina Turner	famous rock
Two Steps from Hell	famous rock
Utada	famous rock
Video Game Players	famous rock
Vishal Dadlani	famous rock
WWE	famous rock
We The Kings	famous rock
Werner Tautz	famous rock
Wham!	famous rock
Whitesnake	famous rock
Woolbright	famous rock
World Order	famous rock
Wrabel	famous rock
YENS	famous rock
Yes	famous rock
Yuma Yamaguchi	famous rock
iDubbbz	famous rock
real1	famous rock
水田 直志	famous rock
10 Years	modern rock
8 Bit Universe	modern rock
A Fine Frenzy	modern rock
AJJ	modern rock
Adam Youngman	modern rock
Adrian Belew	modern rock
Agnes Obel	modern rock
Air	modern rock
Alabama Shakes	modern rock
Alex Ebert	modern rock
Alex Turner	modern rock
Alexi Murdoch	modern rock
Alice In Chains	modern rock
Alina Pash	modern rock
Allison Moorer	modern rock
Alphabeat	modern rock
Alter Bridge	modern rock
Amadou & Mariam	modern rock
Amber Run	modern rock
Ambrosia	modern rock
Ambulance LTD	modern rock
American Football	modern rock
Amigo the Devil	modern rock
Anberlin	modern rock
Andrew Bird	modern rock
Andy McKee	modern rock
Ane Brun	modern rock
Angels & Airwaves	modern rock
Angus & Julia Stone	modern rock
Anthony Hamilton	modern rock
Antônio Carlos Jobim	modern rock
Aphrodite's Child	modern rock
Arcade Fire	modern rock
Arctic Monkeys	modern rock
Astronautalis	modern rock
Astronauts, etc.	modern rock
Astrud Gilberto	modern rock
Atlas Genius	modern rock
Average White Band	modern rock
B.B. King	modern rock
BOY	modern rock
Back Door Slam	modern rock
Band of Horses	modern rock
Bat For Lashes	modern rock
Battles	modern rock
Beans on Toast	modern rock
Bear Hands	modern rock
Bear Vs. Shark	modern rock
Bell X1	modern rock
Ben Caplan	modern rock
Ben Folds Five	modern rock
Ben Howard	modern rock
Benjamin Tod	modern rock
Biffy Clyro	modern rock
Big Bill Broonzy	modern rock
Big Star	modern rock
Big Wreck	modern rock
Bill Withers	modern rock
Birdy	modern rock
Black Books	modern rock
Blaze Foley	modern rock
Blind Melon	modern rock
Blind Pilot	modern rock
Bloc Party	modern rock
Blue October	modern rock
Bobby Womack	modern rock
Bohren & Der Club Of Gore	modern rock
Bomb the Music Industry!	modern rock
Bombay Bicycle Club	modern rock
Bombino	modern rock
Bon Iver	modern rock
"Bonnie ""Prince"" Billy"	modern rock
Bosnian Rainbows	modern rock
Bran Van 3000	modern rock
Brass Against	modern rock
Brian Eno	modern rock
Bright Eyes	modern rock
Broken Bells	modern rock
Brother Dege	modern rock
Brown Bird	modern rock
Bruno Pernadas	modern rock
Buckethead	modern rock
Built To Spill	modern rock
CRUISR	modern rock
CSS	modern rock
Cage The Elephant	modern rock
Calexico	modern rock
Cam	modern rock
Camel	modern rock
Captain Beefheart & His Magic Band	modern rock
Caro Emerald	modern rock
Cat Power	modern rock
Catfish and the Bottlemen	modern rock
Cavetown	modern rock
Charles Bradley	modern rock
Cherub	modern rock
Chevelle	modern rock
Chon	modern rock
Chris Cornell	modern rock
Christy Moore	modern rock
Chromeo	modern rock
Cibo Matto	modern rock
Cigarettes After Sex	modern rock
City and Colour	modern rock
Clarence Carter	modern rock
Cloud Cult	modern rock
CocoRosie	modern rock
Coheed and Cambria	modern rock
Cold War Kids	modern rock
Colin Hay	modern rock
Collective Soul	modern rock
Concorde	modern rock
Conway Twitty	modern rock
Copeland	modern rock
Cosmo Sheldrake	modern rock
Cotton Jones	modern rock
Cro	modern rock
Crobot	modern rock
Crystal Castles	modern rock
Crystal Mad	modern rock
Cursive	modern rock
DREAMERS	modern rock
Damien Rice	modern rock
Damon Albarn	modern rock
Dan Le Sac	modern rock
Danger Mouse	modern rock
Daniel Johnston	modern rock
Daniela Andrade	modern rock
Darondo	modern rock
Daughter	modern rock
Dave Brubeck	modern rock
David Bazan	modern rock
David Gray	modern rock
Dawes	modern rock
Dawn Golden	modern rock
De Staat	modern rock
DeBarge	modern rock
Dead Man's Bones	modern rock
Dead Sara	modern rock
Dear Rouge	modern rock
Death Cab for Cutie	modern rock
Death From Above 1979	modern rock
Deep Forest	modern rock
Deftones	modern rock
Delta Rae	modern rock
Delta Spirit	modern rock
Destroy Boys	modern rock
Devendra Banhart	modern rock
Diabolus Exterminus	modern rock
Dinosaur Jr.	modern rock
Dirty Loops	modern rock
Dismemberment Plan	modern rock
Dizzi Dulcimer	modern rock
Donny Hathaway	modern rock
Dr. Dog	modern rock
Dredg	modern rock
Dry the River	modern rock
Dustin Kensrue	modern rock
Eddie Vedder	modern rock
Edna Swap	modern rock
Edward Sharpe & The Magnetic Zeros	modern rock
Eels	modern rock
El Guincho	modern rock
El Ten Eleven	modern rock
Elliott Smith	modern rock
Emmy The Great	modern rock
Empire of the Sun	modern rock
Emrlds	modern rock
Escort	modern rock
Estas Tonne	modern rock
Estradasphere	modern rock
Eve 6	modern rock
Evelyn Evelyn	modern rock
Everclear	modern rock
Explosions In The Sky	modern rock
Failure	modern rock
Fair To Midland	modern rock
Family of the Year	modern rock
Feist	modern rock
Fever Ray	modern rock
Final Fantasy	modern rock
Fink	modern rock
Fiona Apple	modern rock
Five Iron Frenzy	modern rock
Fleet Foxes	modern rock
Foals	modern rock
Focus	modern rock
Foster The People	modern rock
France Gall	modern rock
Francisco Tárrega	modern rock
Franz Ferdinand	modern rock
Friendly Fires	modern rock
Frou Frou	modern rock
Fujiya & Miyagi	modern rock
Full Eclipse	modern rock
GRADES	modern rock
Gary Clark Jr.	modern rock
Gary Moore	modern rock
Gary Numan	modern rock
Gavin Bryars	modern rock
Gavin Castleton	modern rock
Gayngs	modern rock
Gerard Way	modern rock
Gilbert O'Sullivan	modern rock
Giles Corey	modern rock
Girl Talk	modern rock
Girls	modern rock
Glass Animals	modern rock
Glen Hansard	modern rock
Gloria Jones	modern rock
Godspeed You! Black Emperor	modern rock
Gorillaz	modern rock
Gotan Project	modern rock
Grandaddy	modern rock
Gregory Alan Isakov	modern rock
Gregory and the Hawk	modern rock
Grizzly Bear	modern rock
Groove Armada	modern rock
Grouplove	modern rock
Guillemots	modern rock
Hamitr	modern rock
Hatriot	modern rock
Her	modern rock
Here Come The Mummies	modern rock
Hezekiah	modern rock
Hobo Johnson	modern rock
Hooverphonic	modern rock
Horse Feathers	modern rock
Hum	modern rock
Hymie's Basement	modern rock
Hypnotic Brass Ensemble	modern rock
HÆLOS	modern rock
I Fight Dragons	modern rock
I Monster	modern rock
I'm From Barcelona	modern rock
Ibrahim Maalouf	modern rock
Immortal Technique	modern rock
In The Valley Below	modern rock
Iron & Wine	modern rock
Iron Horse	modern rock
J-MAN	modern rock
JR JR	modern rock
Jaala	modern rock
Jack Johnson	modern rock
Jack Stauber	modern rock
Jack Stauber's Micropop	modern rock
Jack White	modern rock
Jackson C. Frank	modern rock
Jake Shimabukuro	modern rock
Jane Bordeaux	modern rock
Jason Becker	modern rock
Jeff Buckley	modern rock
Jeffrey Lewis	modern rock
Jellyfish	modern rock
Jerry Douglas	modern rock
Jets To Brazil	modern rock
Jimmie's Chicken Shack	modern rock
Joe Cocker	modern rock
John Butler Trio	modern rock
John Moreland	modern rock
Johnny Flynn	modern rock
Johnny Foreigner	modern rock
Josef Salvat	modern rock
Josh Ritter	modern rock
José González	modern rock
Joywave	modern rock
July Talk	modern rock
Jungle	modern rock
Justin Townes Earle	modern rock
Jónsi	modern rock
Kaizers Orchestra	modern rock
Kaleida	modern rock
Karen O	modern rock
Karen Souza	modern rock
Kasabian	modern rock
Kate Miller-Heidke	modern rock
Keak Da Sneak	modern rock
Keaton Henson	modern rock
Keith Mansfield	modern rock
Kele	modern rock
Keller Williams	modern rock
Kendra Morris	modern rock
Kensington	modern rock
Kid Indigo	modern rock
Kimbra	modern rock
King Crimson	modern rock
Kings of Convenience	modern rock
Kingston Wall	modern rock
LCD Soundsystem	modern rock
LEN	modern rock
LP	modern rock
Land of Talk	modern rock
Larkin Poe	modern rock
Late Night Tales	modern rock
Late of the Pier	modern rock
Laura Stevenson	modern rock
Lee Fields & The Expressions	modern rock
Lemmino	modern rock
Lemon Jelly	modern rock
Leon Bridges	modern rock
Lewis Del Mar	modern rock
Lianne La Havas	modern rock
Lightning Bolt	modern rock
Lightspeed Champion	modern rock
Lisa Gerrard	modern rock
Lissie	modern rock
Listener	modern rock
Little Joy	modern rock
Live	modern rock
London Grammar	modern rock
Lord Huron	modern rock
Los Campesinos!	modern rock
Lost In The Trees	modern rock
Loudon Wainwright III	modern rock
Louis Prima	modern rock
Lovage	modern rock
Luck Mervil	modern rock
Ludo	modern rock
M	modern rock
M. Ward	modern rock
M83	modern rock
MCC [Magna Carta Cartel]	modern rock
MS MR	modern rock
Mad Season	modern rock
Magic Man	modern rock
Man Man	modern rock
Manchester Orchestra	modern rock
Mariachi El Bronx	modern rock
Mariami	modern rock
Martha Wainright	modern rock
Massive Attack	modern rock
Matt Berry	modern rock
Max Romeo	modern rock
Maxence Cyrin	modern rock
Maximo Park	modern rock
Medeski Scofield Martin & Wood	modern rock
Melanie	modern rock
Menomena	modern rock
Metric	modern rock
Metronomy	modern rock
Michael Manring	modern rock
Midlake	modern rock
Milky Chance	modern rock
Mindsight	modern rock
Minnie Riperton	modern rock
Minus the Bear	modern rock
Miracle Musical	modern rock
Mirel Wagner	modern rock
Mississippi John Hurt	modern rock
Mob 47	modern rock
Modest Mouse	modern rock
Mogwai	modern rock
Mono	modern rock
Monsters Calling Home	modern rock
Moon Hooch	modern rock
Moondog	modern rock
Morphine	modern rock
Moss Icon	modern rock
Mother Mother	modern rock
Mr. Bungle	modern rock
Mumford & Sons	modern rock
Murder By Death	modern rock
Mutemath	modern rock
My Bloody Valentine	modern rock
My Morning Jacket	modern rock
My Vitriol	modern rock
Mélanie Laurent	modern rock
NOFX	modern rock
Nahko And Medicine For The People	modern rock
Nerf Herder	modern rock
Neuromonakh Feofan	modern rock
Neutral Milk Hotel	modern rock
New Order	modern rock
New Radicals	modern rock
Nick Dow	modern rock
Nick Drake	modern rock
Nickel Creek	modern rock
NineFX	modern rock
Noah And The Whale	modern rock
Noah Gundersen	modern rock
November 5	modern rock
Novo Amor	modern rock
O'keefe Music Foundation	modern rock
Ohio Players	modern rock
Okkervil River	modern rock
Old & In The Way	modern rock
Old 97's	modern rock
Omar Rodriguez Lopez	modern rock
Ozric Tentacles	modern rock
P.O.D.	modern rock
PVRIS	modern rock
Palms	modern rock
Paolo Buonvino	modern rock
Paolo Nutini	modern rock
Papadosio	modern rock
Part Native	modern rock
Passenger	modern rock
Passion Pit	modern rock
Pat Metheny	modern rock
Patrick Street	modern rock
Peeping Tom	modern rock
Penguin Cafe Orchestra	modern rock
Phantogram	modern rock
Pharmakon	modern rock
Philip Glass	modern rock
Phish	modern rock
Phoenix	modern rock
Phosphorescent	modern rock
Pigeons Playing Ping Pong	modern rock
Pinback	modern rock
Placebo	modern rock
Plan B	modern rock
Poets of the Fall	modern rock
Polyphia	modern rock
Porcupine Tree	modern rock
Portishead	modern rock
Portugal. The Man	modern rock
Powderfinger	modern rock
Primitive Radio Gods	modern rock
Priscilla Ahn	modern rock
Punch Brothers	modern rock
Punk Shop Boys	modern rock
Purify	modern rock
Quincy Jones	modern rock
RJD2	modern rock
Ra Ra Riot	modern rock
Radical Face	modern rock
Radiohead	modern rock
Ray LaMontagne	modern rock
Red House Painters	modern rock
Regina Spektor	modern rock
Relient K	modern rock
Reuben	modern rock
Revis	modern rock
Rilo Kiley	modern rock
Rise Against	modern rock
Rob Scallon	modern rock
Robert DeLong	modern rock
Rodrigo y Gabriela	modern rock
Roger Waters	modern rock
Rogue Wave	modern rock
Roky Erickson	modern rock
Roy Buchanan	modern rock
Royal Blood	modern rock
Rusted Root	modern rock
Rx Bandits	modern rock
Ryan Adams	modern rock
Ryan Paris	modern rock
Ryuichi Sakamoto	modern rock
STRFKR	modern rock
STS9	modern rock
Sadistik	modern rock
San Cisco	modern rock
Santigold	modern rock
Sarah Jaffe	modern rock
Saul Williams	modern rock
Scarlett Johansson	modern rock
Scott Walker	modern rock
Screamin' Jay Hawkins	modern rock
Seafret	modern rock
Sean Hayes	modern rock
Seu Jorge	modern rock
Shakey Graves	modern rock
Sharon Jones & The Dap-Kings	modern rock
Shihad	modern rock
Sibylle Baier	modern rock
Sigur Rós	modern rock
Silverchair	modern rock
Silversun Pickups	modern rock
Sir Sly	modern rock
Sixx:A.M.	modern rock
Sleigh Bells	modern rock
Sloan	modern rock
Slow Club	modern rock
Small Faces	modern rock
Small Town Titans	modern rock
Smallpools	modern rock
Smog	modern rock
SoMo	modern rock
Soap&Skin	modern rock
Soko	modern rock
Sol Seppy	modern rock
Songs: Ohia	modern rock
Spacehog	modern rock
Spoonbill	modern rock
Stabbing Westward	modern rock
Stan Getz	modern rock
Stars	modern rock
Steam Powered Giraffe	modern rock
Steven Wilson	modern rock
Sticky Fingers	modern rock
Stiff Little Fingers	modern rock
Straight Up	modern rock
Streetlight Manifesto	modern rock
Sufjan Stevens	modern rock
Sun Kil Moon	modern rock
Sunna	modern rock
Super Furry Animals	modern rock
Supergrass	modern rock
Swiss Lips	modern rock
TV On The Radio	modern rock
Tacocat	modern rock
Tame Impala	modern rock
Tash Sultana	modern rock
Tauk	modern rock
Tedeschi Trucks Band	modern rock
Television	modern rock
The Academic	modern rock
The Airborne Toxic Event	modern rock
The Album Leaf	modern rock
The Antlers	modern rock
The Apples In Stereo	modern rock
The Asteroids Galaxy Tour	modern rock
The Avett Brothers	modern rock
The Black Angels	modern rock
The Blow	modern rock
The Boy Least Likely To	modern rock
The Brobecks	modern rock
The Cat Empire	modern rock
The Chain Gang Of 1974	modern rock
The Cinematic Orchestra	modern rock
The Coral	modern rock
The Crack	modern rock
The Cramps	modern rock
The Dead Weather	modern rock
The Dear Hunter	modern rock
The Decemberists	modern rock
The Devil Makes Three	modern rock
The Divine Comedy	modern rock
The Donkeys	modern rock
The Easybeats	modern rock
The Flaming Lips	modern rock
The Format	modern rock
The Gaslight Anthem	modern rock
The Head and the Heart	modern rock
The Hillbilly Moon Explosion	modern rock
The Hold Steady	modern rock
The Housemartins	modern rock
The Instant Classic	modern rock
The Jim Carroll Band	modern rock
The Joy Formidable	modern rock
The Kills	modern rock
The King Khan & BBQ Show	modern rock
The Knife	modern rock
The Kooks	modern rock
The Last Shadow Puppets	modern rock
The Libertines	modern rock
The Long Winters	modern rock
The Maccabees	modern rock
The Magnetic Fields	modern rock
The Marcus King Band	modern rock
The Mars Volta	modern rock
The Middle East	modern rock
The Milk Carton Kids	modern rock
The Morning Benders	modern rock
The Mowgli's	modern rock
The Naked And Famous	modern rock
The Oh Hellos	modern rock
The Paper Chase	modern rock
The Paper Kites	modern rock
The Postal Service	modern rock
The Presets	modern rock
The Prize Fighter Inferno	modern rock
The Psychedelic Furs	modern rock
The Raconteurs	modern rock
The Reign of Kindo	modern rock
The Replacements	modern rock
The Residents	modern rock
The Return	modern rock
The Saboteurs	modern rock
The Shins	modern rock
The Smashing Pumpkins	modern rock
The Spook School	modern rock
The Stone Roses	modern rock
The Strokes	modern rock
The Struts	modern rock
The Sundays	modern rock
The Temper Trap	modern rock
The Temptations	modern rock
The The	modern rock
The Thermals	modern rock
The Undertones	modern rock
The Walkmen	modern rock
The Wallflowers	modern rock
The Weakerthans	modern rock
The Weepies	modern rock
The White Buffalo	modern rock
The Whitest Boy Alive	modern rock
The Wombats	modern rock
The Zutons	modern rock
The xx	modern rock
Thedeus White	modern rock
Them Crooked Vultures	modern rock
This Mortal Coil	modern rock
Tim Buckley	modern rock
Tinariwen	modern rock
Tiny Hueman	modern rock
Toh Kay	modern rock
Tom Day	modern rock
Tom Odell	modern rock
Tommy Emmanuel	modern rock
Tonic	modern rock
Toumani Diabaté's Symmetric Orchestra	modern rock
Townes Van Zandt	modern rock
Traffic	modern rock
Trampled by Turtles	modern rock
Traveling Wilburys	modern rock
Trent Reznor and Atticus Ross	modern rock
Trevor Jones	modern rock
Tub Ring	modern rock
Turbonegro	modern rock
Twin Shadow	modern rock
Two Door Cinema Club	modern rock
Two Gallants	modern rock
Tyler Childers	modern rock
UNKLE	modern rock
Umphrey's McGee	modern rock
Us	modern rock
Vast	modern rock
Vercery	modern rock
Vic Chesnutt	modern rock
Vienna Teng	modern rock
Viola Beach	modern rock
Violent Soho	modern rock
Vitamin String Quartet	modern rock
We Were Promised Jetpacks	modern rock
Weather Report	modern rock
White Denim	modern rock
White Lies	modern rock
Wings	modern rock
Wolf Parade	modern rock
Wolfmother	modern rock
Wye Oak	modern rock
Yeah Yeah Yeahs	modern rock
You Me At Six	modern rock
Young the Giant	modern rock
Yung Joc	modern rock
Zach Wright	modern rock
Zeb Newby and The Visibly Upset	modern rock
Zero 7	modern rock
Zero Detail	modern rock
alt-J	modern rock
an Unkindness	modern rock
boy pablo	modern rock
k.d. lang	modern rock
mewithoutYou	modern rock
the bird and the bee	modern rock
the one and only PPL MVR	modern rock
Ásgeir	modern rock
Ólafur Arnalds	modern rock
✝✝✝ (Crosses)	modern rock
100%	k-pop
2PM	k-pop
9MUSES	k-pop
A.C.E	k-pop
AMBER	k-pop
ASTRO	k-pop
ATEEZ	k-pop
BTOB	k-pop
Baek A Yeon	k-pop
Beast	k-pop
Block B	k-pop
BoA	k-pop
Bolbbalgan4	k-pop
Brave Girls	k-pop
CHANYEOL	k-pop
CLC	k-pop
Cities Aviv	k-pop
DAY6	k-pop
DREAMCATCHER	k-pop
Dalshabet	k-pop
Dario Nunez	k-pop
EXO-CBX	k-pop
Eric Nam	k-pop
GFRIEND	k-pop
Girls' Generation-Oh!GG	k-pop
Girls' Generation-TTS	k-pop
HYO	k-pop
I.O.I	k-pop
JJ Project	k-pop
JONGHYUN	k-pop
Jessica	k-pop
Jukio Kallio	k-pop
KARA	k-pop
KNK	k-pop
LADIES' CODE	k-pop
Lovelyz	k-pop
Mamamoo	k-pop
Monsta X	k-pop
NCT 127	k-pop
NCT DREAM	k-pop
NU'EST W	k-pop
OH MY GIRL	k-pop
PRODUCE 101	k-pop
RAINBOW	k-pop
SEJEONG	k-pop
SEVENTEEN	k-pop
SHINee	k-pop
SUPER JUNIOR	k-pop
Stray Kids	k-pop
TAEMIN	k-pop
TVXQ!	k-pop
Tiffany Young	k-pop
VIXX	k-pop
WINNER	k-pop
WJSN	k-pop
Wanna One	k-pop
YURI (Girls’ Generation)	k-pop
berrygood	k-pop
fromis_9	k-pop
gugudan	k-pop
iKON	k-pop
1000mods	alternative metal
Aeon	alternative metal
Agalloch	alternative metal
Alcest	alternative metal
Alexis Neon	alternative metal
Amaranthe	alternative metal
Amebix	alternative metal
Amorphis	alternative metal
Anaal Nathrakh	alternative metal
Anal Cunt	alternative metal
Anathema	alternative metal
Animals As Leaders	alternative metal
Arcane Roots	alternative metal
Arch Enemy	alternative metal
Arkona	alternative metal
Astronoid	alternative metal
Avantasia	alternative metal
Baroness	alternative metal
Battle Beast	alternative metal
Beast In Black	alternative metal
Behemoth	alternative metal
Blitzkrieg	alternative metal
Blood Stain Child	alternative metal
Bloodbath	alternative metal
Bolt Thrower	alternative metal
Boris	alternative metal
Brendon Small	alternative metal
Brujeria	alternative metal
Carnivore	alternative metal
Cattle Decapitation	alternative metal
Children Of Bodom	alternative metal
Closure in Moscow	alternative metal
Cradle Of Filth	alternative metal
Cult Of Luna	alternative metal
D.R.I.	alternative metal
Dark Tranquillity	alternative metal
Darkthrone	alternative metal
David Maxim Micic	alternative metal
Dead & Company	alternative metal
Dead Letter Circus	alternative metal
Deafheaven	alternative metal
Death	alternative metal
Demons & Wizards	alternative metal
DevilDriver	alternative metal
Devin Townsend	alternative metal
Devin Townsend Band	alternative metal
Devin Townsend Project	alternative metal
Diablo Swing Orchestra	alternative metal
Diamond Head	alternative metal
Dio	alternative metal
Dream Theater	alternative metal
Earthless	alternative metal
Electric Wizard	alternative metal
Emperor	alternative metal
Ensiferum	alternative metal
Eternity Forever	alternative metal
Falkenbach	alternative metal
Finntroll	alternative metal
Fleshgod Apocalypse	alternative metal
Genghis Tron	alternative metal
Ghost Bath	alternative metal
Gloryhammer	alternative metal
Goblin Cock	alternative metal
Gojira	alternative metal
Grand Magus	alternative metal
Graveyard	alternative metal
Havok	alternative metal
Helloween	alternative metal
ISIS	alternative metal
In Flames	alternative metal
Intervals	alternative metal
Iron Reagan	alternative metal
Ivar Bjørnson & Einar Selvik	alternative metal
Jinjer	alternative metal
K1ngsam	alternative metal
Karnivool	alternative metal
Katatonia	alternative metal
King Diamond	alternative metal
Kvelertak	alternative metal
Kyuss	alternative metal
Lamb of God	alternative metal
Lantlôs	alternative metal
Life Of Agony	alternative metal
Little Tybee	alternative metal
Lost Horizon	alternative metal
Lotus 	alternative metal
Machine Head	alternative metal
Melvins	alternative metal
Mercyful Fate	alternative metal
Meshuggah	alternative metal
Mutoid Man	alternative metal
Myrkur	alternative metal
Nails	alternative metal
Ne Obliviscaris	alternative metal
Nekrogoblikon	alternative metal
Nine Treasures	alternative metal
Northern Kings	alternative metal
OM	alternative metal
Oceansize	alternative metal
OnlyM	alternative metal
Opeth	alternative metal
Orphaned Land	alternative metal
Oscar Peterson	alternative metal
Owane	alternative metal
Panopticon	alternative metal
Paradise Lost	alternative metal
Pelican	alternative metal
Periphery	alternative metal
Pigeon Hole	alternative metal
Plini	alternative metal
Power Trip	alternative metal
Powerglove	alternative metal
Powerwolf	alternative metal
Project Revise	alternative metal
Protest The Hero	alternative metal
Raised Fist	alternative metal
Raubtier	alternative metal
Rotting Christ	alternative metal
Russian Circles	alternative metal
Savatage	alternative metal
Scale The Summit	alternative metal
Selahattin Özdemir	alternative metal
Sepultura	alternative metal
Shining	alternative metal
Sleep	alternative metal
Sleep Token	alternative metal
Sleepytime Gorilla Museum	alternative metal
Sonata Arctica	alternative metal
Subvision	alternative metal
Sunn 0)))	alternative metal
Symphony X	alternative metal
Tengger Cavalry	alternative metal
Teräsbetoni	alternative metal
Thank You Scientist	alternative metal
The Algorithm	alternative metal
The Dillinger Escape Plan	alternative metal
The Sword	alternative metal
The Tony Danza Tapdance Extravaganza	alternative metal
Torche	alternative metal
Tremonti	alternative metal
Truckfighters	alternative metal
Tuomas Holopainen	alternative metal
Turisas	alternative metal
Twelve Foot Ninja	alternative metal
Týr	alternative metal
Ulver	alternative metal
Uncle Acid & The Deadbeats	alternative metal
Unleash The Archers	alternative metal
Vitalism	alternative metal
Wintersun	alternative metal
Woods Of Ypres	alternative metal
X JAPAN	alternative metal
ZETA	alternative metal
Zeal & Ardor	alternative metal
Zu	alternative metal
10cc	rock2
12xAM	rock2
2CELLOS	rock2
4 Non Blondes	rock2
A Perfect Circle	rock2
AFI	rock2
Aaron Copland	rock2
Adolescents	rock2
Afroman	rock2
Against All Authority	rock2
Ages and Ages	rock2
Air Supply	rock2
Airbourne	rock2
Al Green	rock2
Al Stewart	rock2
Alestorm	rock2
Alice Cooper	rock2
Alien Weaponry	rock2
Amanda Palmer	rock2
America	rock2
Ameritz - Karaoke	rock2
Amii Stewart	rock2
Amon Amarth	rock2
Amy Macdonald	rock2
Amy Winehouse	rock2
Annie Lennox	rock2
Anthrax	rock2
Antonio Vivaldi	rock2
Antonín Dvořák	rock2
Apocalyptica	rock2
Aram Khachaturian	rock2
Aretha Franklin	rock2
Arnocorps	rock2
Arrested Development	rock2
Art Garfunkel	rock2
Arvo Pärt	rock2
Astor Piazzolla	rock2
Audioslave	rock2
Avatar	rock2
Avenged Sevenfold	rock2
Avril Lavigne	rock2
Backstreet Boys	rock2
Bad Religion	rock2
Bad Wolves	rock2
Barns Courtney	rock2
Bastille	rock2
Beastie Boys	rock2
Beck	rock2
Bee Gees	rock2
Belinda Carlisle	rock2
Ben Folds	rock2
Berlin	rock2
Bernard Herrmann	rock2
Beyoncé	rock2
Bic Runga	rock2
Big Audio Dynamite	rock2
Big Data	rock2
Bill Haley & His Comets	rock2
Billie Holiday	rock2
Billy Idol	rock2
Billy Joel	rock2
Billy Talent	rock2
Bing Crosby	rock2
Black Flag	rock2
Black Sabbath	rock2
Blake Shelton	rock2
Blind Guardian	rock2
Blondie	rock2
Blue Man Group	rock2
Blues Traveler	rock2
Blur	rock2
Bob Dylan	rock2
Bob Seger	rock2
Bobcat Goldthwait	rock2
Boney M.	rock2
Boston	rock2
Bowling For Soup	rock2
Boz Scaggs	rock2
Breaking Benjamin	rock2
Britney Spears	rock2
Bronski Beat	rock2
Bruce Cockburn	rock2
Bruce Springsteen	rock2
Bryan Adams	rock2
Bryan Ferry	rock2
Buckcherry	rock2
Burlap the Sac	rock2
Bush	rock2
Busta Rhymes	rock2
Butthole Surfers	rock2
CHIC	rock2
CHINCHILLA	rock2
Cable Boy	rock2
Cactus Erectus	rock2
Caesars	rock2
Cake	rock2
Camille Saint-Saëns	rock2
Cancer Bats	rock2
Candlebox	rock2
Canned Heat	rock2
Cannibal Corpse	rock2
Capital Cities	rock2
Caramel	rock2
Carl Orff	rock2
Carly Rae Jepsen	rock2
Carly Simon	rock2
Carpenters	rock2
Cartel	rock2
Casseth	rock2
Cat Trumpet	rock2
Charlie Parra del Riego	rock2
Charmian Carr	rock2
Chesney Hawkes	rock2
Chet Faker	rock2
Chicago	rock2
Chris Isaak	rock2
Chris Stapleton	rock2
Christina Aguilera	rock2
Christina Perri	rock2
Chronic	rock2
Claude Debussy	rock2
Clown Core	rock2
Clutch	rock2
Coldplay	rock2
Concrete Blonde	rock2
Corey Feldman	rock2
Corey Taylor	rock2
Cornershop	rock2
Corona	rock2
Cowboy Mouth	rock2
Cracker	rock2
Crass	rock2
Crazy Town	rock2
Cream	rock2
Creedence Clearwater Revival	rock2
Crosby, Stills, Nash & Young	rock2
Crowded House	rock2
Cuffed Up	rock2
Curtis Mayfield	rock2
Cutting Crew	rock2
Cyndi Lauper	rock2
Céline Dion	rock2
Dada	rock2
Dan Milner	rock2
Danzig	rock2
Daron Malakian and Scars On Broadway	rock2
Daryl Hall & John Oates	rock2
Data	rock2
Dave Grohl	rock2
Dave Matthews Band	rock2
David Banner	rock2
David Bowie	rock2
David Gilmour	rock2
Dead Prez	rock2
Dean Martin	rock2
Dean Ween Group	rock2
Deee-Lite	rock2
Deep Purple	rock2
Def Leppard	rock2
Depeche Mode	rock2
Dexys Midnight Runners	rock2
Diana Ross	rock2
Dire Straits	rock2
Dmitri Shostakovich	rock2
Dojo Cuts	rock2
Dolly Parton	rock2
Dorothy	rock2
Doyle	rock2
Dr. John	rock2
Drive-By Truckers	rock2
Duran Duran	rock2
Eagle-Eye Cherry	rock2
Eagles Of Death Metal	rock2
Echo & the Bunnymen	rock2
Echosmith	rock2
Ed Sheeran	rock2
Eddy Grant	rock2
Edmund Rubbra	rock2
Edvard Grieg	rock2
Eilen Jewell	rock2
Einstürzende Neubauten	rock2
Electric Light Orchestra	rock2
Electronic	rock2
Ella Fitzgerald	rock2
Elle King	rock2
Ellie Goulding	rock2
Elton John	rock2
Eluveitie	rock2
Elvin Bishop	rock2
Elvis Costello	rock2
Elvis Costello & The Attractions	rock2
Elvis Presley	rock2
Emergency Broadcast Network	rock2
En Vogue	rock2
Engelbert Humperdinck	rock2
Enigma	rock2
Enya	rock2
Eric Church	rock2
Eric Clapton	rock2
Erik Satie	rock2
Ernie	rock2
Etran Finatawa	rock2
Etta James	rock2
Extreme	rock2
Fairuz	rock2
Faith No More	rock2
Farrah Abraham	rock2
Fastball	rock2
Faul & Wad Ad	rock2
Federico Dubbini	rock2
Feeder	rock2
Filter	rock2
Fitz and The Tantrums	rock2
Fleetwood Mac	rock2
Fleur East	rock2
Flo Rida	rock2
Florence + The Machine	rock2
Florida Georgia Line	rock2
Foo Fighters	rock2
Foreign Air	rock2
Foreigner	rock2
Four Tops	rock2
Frank Sinatra	rock2
Frank Turner	rock2
Frank Zappa	rock2
Frankie Valli & The Four Seasons	rock2
Frankie Yankovic & His Yanks	rock2
Franz Liszt	rock2
Franz Schubert	rock2
Freddie King	rock2
Frog Eyes	rock2
Frédéric Chopin	rock2
Fugazi	rock2
GG Allin	rock2
Gabriel Fauré	rock2
Gabriella Cilmi	rock2
Gabrielle	rock2
Galactic Empire	rock2
Garbage	rock2
Gary Glitter	rock2
Genesis	rock2
George Gershwin	rock2
George Harrison	rock2
George Jones	rock2
George Strait	rock2
George Winston	rock2
Gerry Rafferty	rock2
Geto Boys	rock2
Ghost	rock2
Gigi D'Agostino	rock2
Gin Blossoms	rock2
Gioachino Rossini	rock2
Gnarls Barkley	rock2
Godsmack	rock2
Golden Earring	rock2
Goldfinger	rock2
Good Charlotte	rock2
Grace Jones	rock2
Great Dane	rock2
Great White	rock2
Green Day	rock2
Greta Van Fleet	rock2
Guns N' Roses	rock2
Gustav Holst	rock2
Gustav Mahler	rock2
Gwen Stefani	rock2
HOTEI	rock2
Hank Williams III	rock2
Harry Belafonte	rock2
Harry Nilsson	rock2
Harvey Danger	rock2
Hatebreed	rock2
Heart	rock2
Hellogoodbye	rock2
Helmet	rock2
Henry Mancini	rock2
Highly Suspect	rock2
Hole	rock2
Hollywood Undead	rock2
Hoobastank	rock2
Hootie & The Blowfish	rock2
Horse The Band	rock2
Hozier	rock2
Huey Lewis & The News	rock2
Hugh Laurie	rock2
Humble Pie	rock2
I Prevail	rock2
IAMX	rock2
INXS	rock2
IV Of Spades	rock2
Icon For Hire	rock2
Idontknowjeffery	rock2
Iggy Pop	rock2
Igor Stravinsky	rock2
Imogen Heap	rock2
In This Moment	rock2
Incubus	rock2
Inedia	rock2
Ingrid Michaelson	rock2
Iron Butterfly	rock2
Iron Maiden	rock2
Isaac Hayes	rock2
Jack's Mannequin	rock2
Jackson Browne	rock2
James Bay	rock2
James Brown	rock2
James Brown & The Famous Flames	rock2
James Taylor	rock2
Jamiroquai	rock2
Jan & Dean	rock2
Jan Hammer	rock2
Janaitis	rock2
Jane's Addiction	rock2
Jason Derulo	rock2
Jason Isbell	rock2
Jason Isbell and the 400 Unit	rock2
Jason Mraz	rock2
Jason Weaver	rock2
Jaymes Young	rock2
Jean Sibelius	rock2
Jim Croce	rock2
Jimi Hendrix	rock2
Jimmy Buffett	rock2
Jimmy Eat World	rock2
Joan Baez	rock2
Joe Jackson	rock2
Johann Pachelbel	rock2
Johann Sebastian Bach	rock2
Johann Strauss II	rock2
John Adams	rock2
John Denver	rock2
John Farnham	rock2
John Fogerty	rock2
John Frusciante	rock2
John Lennon	rock2
John Luther Adams	rock2
John Mayer	rock2
John Popper	rock2
John Prine	rock2
John Waite	rock2
Johnny Cash	rock2
Johnny Mandel	rock2
Jordi Savall	rock2
Joseph Stevenson	rock2
Joy Division	rock2
Judah & the Lion	rock2
Judas Priest	rock2
Juice Newton	rock2
Justice & Metro	rock2
K-OS	rock2
KALEO	rock2
KAUAN	rock2
KISS	rock2
KMFDM	rock2
KONGOS	rock2
Kate Bush	rock2
Kate Tempest	rock2
Katie Melua	rock2
Keane	rock2
Kellzy	rock2
Kenny Chesney	rock2
Kevin Rudolf	rock2
Kim Carnes	rock2
King 810	rock2
Kings of Leon	rock2
Kino	rock2
Kirsty MacColl	rock2
Kleerup	rock2
Klingande	rock2
Knstrktvst	rock2
Kodaline	rock2
Korn	rock2
Korpiklaani	rock2
Kraftwerk	rock2
La Roux	rock2
Lady Gaga	rock2
Ladytron	rock2
Lana Del Rey	rock2
Lana Lubany	rock2
Lauren Daigle	rock2
Laurie Anderson	rock2
Led Zeppelin	rock2
Lenny Kravitz	rock2
Leonard Cohen	rock2
Less Than Jake	rock2
Lily Allen	rock2
Lindsey Stirling	rock2
Link Wray	rock2
Liquido	rock2
Lit	rock2
Little Eva	rock2
Little Richard	rock2
Liz Phair	rock2
Lizzie Miles	rock2
Lorne Greene	rock2
Lou Gramm	rock2
Lou Reed	rock2
Loverboy	rock2
Ludovico Einaudi	rock2
Ludwig van Beethoven	rock2
Luigi Boccherini	rock2
Luigi Denza	rock2
Luke Bryan	rock2
Luke Combs	rock2
Luther Vandross	rock2
MARINA	rock2
MC5	rock2
MGMT	rock2
MIKA	rock2
MKTO	rock2
Macy Gray	rock2
Mad Caddies	rock2
Madness	rock2
Madonna	rock2
Manfred Mann's Earth Band	rock2
Manic Street Preachers	rock2
Manu Chao	rock2
Marcy Playground	rock2
Margot & The Nuclear So And So's	rock2
Mariah Carey	rock2
Marianas Trench	rock2
Marianne Faithfull	rock2
Marilyn Manson	rock2
Mark Knopfler	rock2
Mark Ronson	rock2
Maroon 5	rock2
Martha Reeves & The Vandellas	rock2
Marty Muke	rock2
Mastodon	rock2
Matchbox Twenty	rock2
Maurice Ravel	rock2
Me First and the Gimme Gimmes	rock2
Meat Puppets	rock2
Meg Myers	rock2
Megadeth	rock2
Meghan Trainor	rock2
Melanie Martinez	rock2
Merle Travis	rock2
Metallica	rock2
Metalocalypse: Dethklok	rock2
Michael Fassbender	rock2
Michael Jackson	rock2
Mickey & Sylvia	rock2
Miike Snow	rock2
Mike Oldfield	rock2
Mike Posner	rock2
Miley Cyrus	rock2
Mindless Self Indulgence	rock2
Ministry	rock2
Minor Threat	rock2
Misfits	rock2
Missing Persons	rock2
Modern Talking	rock2
Motörhead	rock2
Mudhoney	rock2
Mudvayne	rock2
Muse	rock2
My Chemical Romance	rock2
Mystk	rock2
Nada Surf	rock2
Nancy Sinatra	rock2
Nat King Cole	rock2
Natalie Imbruglia	rock2
Natalie Merchant	rock2
Nathaniel Rateliff & The Night Sweats	rock2
Naughty Boy	rock2
Neil Young	rock2
Nena	rock2
Neutralize	rock2
Nick Cave & The Bad Seeds	rock2
Nico Vega	rock2
Night Ranger	rock2
Nightwish	rock2
Nina Simone	rock2
Nine Inch Nails	rock2
Ningen Isu	rock2
Nirvana	rock2
No Doubt	rock2
Norah Jones	rock2
Norman Greenbaum	rock2
Nothing More	rock2
O.A.R.	rock2
OMI	rock2
Oasis	rock2
Of Monsters and Men	rock2
Oingo Boingo	rock2
Old Crow Medicine Show	rock2
Olly Murs	rock2
One Direction	rock2
OneRepublic	rock2
Operation Ivy	rock2
Orgy	rock2
Oscar Isaac	rock2
Otis Redding	rock2
Our Lady Peace	rock2
Owl City	rock2
P!nk	rock2
PJ Harvey	rock2
PSY	rock2
Panic! At The Disco	rock2
Pantera	rock2
Paramore	rock2
Parliament	rock2
Party Cannon	rock2
Pat Boone	rock2
Patrick Stump	rock2
Patti Page	rock2
Patti Smith	rock2
Paul McCartney	rock2
Paul Simon	rock2
Pearl Jam	rock2
Pentatonix	rock2
Pet Shop Boys	rock2
Pete Shelley	rock2
Peter Gabriel	rock2
Phil Collins	rock2
Phillip Phillips	rock2
Pickin' On Series	rock2
Pink Floyd	rock2
Pissed Jeans	rock2
Pixies	rock2
Plain White T's	rock2
Poe	rock2
Pogo	rock2
Pokey LaFarge	rock2
Pretenders	rock2
Primus	rock2
Prince	rock2
Priscilla Renea	rock2
Propagandhi	rock2
Psychostick	rock2
Puddle Of Mudd	rock2
Pulp	rock2
Puscifer	rock2
Pyotr Ilyich Tchaikovsky	rock2
Q Lazzarus	rock2
Queens of the Stone Age	rock2
Queensrÿche	rock2
R.E.M.	rock2
REO Speedwagon	rock2
Ralph Vaughan Williams	rock2
Ramones	rock2
Rancid	rock2
Raphael Saadiq	rock2
Rare Americans	rock2
Rascal Flatts	rock2
Ratatat	rock2
Real Life	rock2
Reba McEntire	rock2
Red	rock2
Red Fang	rock2
Red Hot Chili Peppers	rock2
Red Rider	rock2
Reel Big Fish	rock2
Refused	rock2
Richard Marx	rock2
Richard Strauss	rock2
Richie Havens	rock2
Rick James	rock2
Rihanna	rock2
Rixton	rock2
Rob Bailey & The Hustle Standard	rock2
Rob Base & DJ EZ Rock	rock2
Rob Thomas	rock2
Robert Plant	rock2
Rod Stewart	rock2
Ronnie Drew	rock2
Roxette	rock2
Roxy Music	rock2
Roy Orbison	rock2
Run–D.M.C.	rock2
Rush	rock2
Ryan Chin	rock2
SAYGRACE	rock2
STARSET	rock2
Saint Motel	rock2
Salt-N-Pepa	rock2
Sam & Dave	rock2
Sam Cooke	rock2
Santana	rock2
Sara Bareilles	rock2
Savage Garden	rock2
Scala & Kolacny Brothers	rock2
Scissor Sisters	rock2
Scott Bradlee's Postmodern Jukebox	rock2
Scotty Sire	rock2
Scritti Politti	rock2
Seether	rock2
Selena Gomez & The Scene	rock2
Serengeti	rock2
Sergei Prokofiev	rock2
Sergei Rachmaninoff	rock2
Serj Tankian	rock2
Shakira	rock2
Shinedown	rock2
Shocking Blue	rock2
Sia	rock2
Sick Animation	rock2
Simply Red	rock2
Sinéad O'Connor	rock2
Skálmöld	rock2
Slayer	rock2
Sleeping At Last	rock2
Slipknot	rock2
Sly & The Family Stone	rock2
Smokey Robinson & The Miracles	rock2
Sneaker Pimps	rock2
Snow Patrol	rock2
Social Distortion	rock2
Sophie Zelmani	rock2
Soundgarden	rock2
Spandau Ballet	rock2
Spellling	rock2
Spice Girls	rock2
Spin Doctors	rock2
Split Enz	rock2
Squirrel Nut Zippers	rock2
Steely Dan	rock2
Stephen Colbert	rock2
Steps	rock2
Stereophonics	rock2
Stevie Ray Vaughan	rock2
Stevie Wonder	rock2
Sting	rock2
Stone Temple Pilots	rock2
Stray Cats	rock2
Stromae	rock2
Stump	rock2
Sturgill Simpson	rock2
Styx	rock2
Sublime	rock2
Suburban Legends	rock2
Sugar	rock2
Sugar Ray	rock2
Superheaven	rock2
Supertramp	rock2
Suzanne Vega	rock2
Swanky	rock2
Switchfoot	rock2
Syd Barrett	rock2
System Of A Down	rock2
Sólstafir	rock2
T. Rex	rock2
T.J. Miller	rock2
TLC	rock2
TOOL	rock2
Tag Team	rock2
Tal Bachman	rock2
Talking Heads	rock2
Tears For Fears	rock2
Tennessee Ernie Ford	rock2
Tesla	rock2
That Poppy	rock2
The (International) Noise Conspiracy	rock2
The Alan Parsons Project	rock2
The All-American Rejects	rock2
The Allman Brothers Band	rock2
The Animals	rock2
The Aquabats!	rock2
The Archies	rock2
The Art Of Noise	rock2
The Association	rock2
The Avalanches	rock2
The Bangles	rock2
The Beach Boys	rock2
The Beatles	rock2
The Black Keys	rock2
The Bravery	rock2
The Breeders	rock2
The Buggles	rock2
The Calling	rock2
The Cardigans	rock2
The Cars	rock2
The Champs	rock2
The Chieftains	rock2
The Chiffons	rock2
The Civil Wars	rock2
The Colourist	rock2
The Cranberries	rock2
The Cult	rock2
The Cure	rock2
The Darkness	rock2
The Dead South	rock2
The Doors	rock2
The Draymin	rock2
The Dream Academy	rock2
The Five Stairsteps	rock2
The Fugs	rock2
The Gap Band	rock2
The Glorious Sons	rock2
The Goo Goo Dolls	rock2
The Handsome Family	rock2
The Heavy	rock2
The Hives	rock2
The Hollies	rock2
The Irish Rovers	rock2
The Isley Brothers	rock2
The Jackson 5	rock2
The Jam	rock2
The Killers	rock2
The Kinks	rock2
The Knack	rock2
The Langley Schools Music Project	rock2
The Lemonheads	rock2
The Living End	rock2
The London Film Score Orchestra	rock2
The Lumineers	rock2
The Mamas & The Papas	rock2
The Marvelettes	rock2
The Maytals	rock2
The Meters	rock2
The Moldy Peaches	rock2
The Monkees	rock2
The Mountain Goats	rock2
The Neighbourhood	rock2
The Offspring	rock2
The Piano Guys	rock2
The Pogues	rock2
The Police	rock2
The Presidents Of The United States Of America	rock2
The Pussycat Dolls	rock2
The Real McKenzies	rock2
The Red Jumpsuit Apparatus	rock2
The Refreshments	rock2
The Rentals	rock2
The Revivalists	rock2
The Righteous Brothers	rock2
The Rolling Stones	rock2
The Romantics	rock2
The Script	rock2
The Simpsons	rock2
The Smiths	rock2
The So So Glos	rock2
The Sounds	rock2
The Specials	rock2
The Spill Canvas	rock2
The Spinners	rock2
The Stranglers	rock2
The Strumbellas	rock2
The Suicide Machines	rock2
The Supremes	rock2
The Tragically Hip	rock2
The Velvet Underground	rock2
The Verve	rock2
The White Stripes	rock2
The Who	rock2
The Yardbirds	rock2
The Yellow River Boys	rock2
The Zombies	rock2
Theory of a Deadman	rock2
They Might Be Giants	rock2
Third Eye Blind	rock2
Thirty Seconds To Mars	rock2
Thomas Dolby	rock2
Thomas Tallis	rock2
Thousand Foot Krutch	rock2
Thunderclap Newman	rock2
Timbaland	rock2
Todd Snider	rock2
Tokio Hotel	rock2
Tom Cochrane	rock2
Tom Morello: the Nightwatchman	rock2
Tom Petty	rock2
Tom Petty and the Heartbreakers	rock2
Tom Waits	rock2
Tomahawk	rock2
Tommy Safespace and The Libtards	rock2
Toots & The Maytals	rock2
Tove Lo	rock2
Tracey Ullman	rock2
Tracy Chapman	rock2
Traditional	rock2
Train	rock2
Travie McCoy	rock2
Travis	rock2
Trio	rock2
Turnpike Troubadours	rock2
Twenty One Pilots	rock2
Type O Negative	rock2
U2	rock2
Ugly Kid Joe	rock2
Ultravox	rock2
Upon A Burning Body	rock2
Us3	rock2
Vampire Weekend	rock2
Van Canto	rock2
Van Halen	rock2
Van Morrison	rock2
Vance Joy	rock2
Velvet Revolver	rock2
Views	rock2
Violent Femmes	rock2
Volbeat	rock2
WALK THE MOON	rock2
WONK	rock2
Walk Off the Earth	rock2
War	rock2
Warpaint	rock2
Warren Zevon	rock2
Wave Saver	rock2
Waylon Jennings	rock2
Ween	rock2
Weezer	rock2
Wesley Willis	rock2
Wheatus	rock2
Wheeler Walker Jr.	rock2
White Town	rock2
White Zombie	rock2
Whitney Houston	rock2
Whodini	rock2
William Shatner	rock2
Willie Nelson	rock2
Within Temptation	rock2
Wolfgang Amadeus Mozart	rock2
Woodkid	rock2
XTC	rock2
Yael Naim	rock2
Yann Tiersen	rock2
Yazoo	rock2
Yoko Ono	rock2
ZZ Top	rock2
Zac Brown Band	rock2
Zack De La Rocha	rock2
Zager & Evans	rock2
fun.	rock2
half•alive	rock2
hyr	rock2
justjaydan	rock2
lostprophets	rock2
moe.	rock2
t.A.T.u.	rock2
will.i.am	rock2
11 Years of This	WeAreTheMusicMakers
2play4you	WeAreTheMusicMakers
7DD9	WeAreTheMusicMakers
Actobass	WeAreTheMusicMakers
Ambientcloud	WeAreTheMusicMakers
Amour Glamour	WeAreTheMusicMakers
Arrhythmic	WeAreTheMusicMakers
At Dawn	WeAreTheMusicMakers
Boo shane	WeAreTheMusicMakers
Bretsil	WeAreTheMusicMakers
Cesium Swimsuit	WeAreTheMusicMakers
Clever Rooster	WeAreTheMusicMakers
Corrupt Society	WeAreTheMusicMakers
Death Be Not Proud	WeAreTheMusicMakers
Dimmes	WeAreTheMusicMakers
Distant City Light	WeAreTheMusicMakers
E-Clips	WeAreTheMusicMakers
Elan Brio	WeAreTheMusicMakers
Eliot Ash	WeAreTheMusicMakers
Ellis D	WeAreTheMusicMakers
Enrights	WeAreTheMusicMakers
Eric Fernandez 	WeAreTheMusicMakers
Fern Dells	WeAreTheMusicMakers
Fload	WeAreTheMusicMakers
Foxpaw	WeAreTheMusicMakers
Fracmental	WeAreTheMusicMakers
GDQ	WeAreTheMusicMakers
George Ergemlidze	WeAreTheMusicMakers
Gurudutt Perichetla	WeAreTheMusicMakers
Heart Tide	WeAreTheMusicMakers
Hz.	WeAreTheMusicMakers
Ibrahim	WeAreTheMusicMakers
Illicite	WeAreTheMusicMakers
Jake Kaiser	WeAreTheMusicMakers
Joe Turone	WeAreTheMusicMakers
JoeJas	WeAreTheMusicMakers
Jong Sl	WeAreTheMusicMakers
Josh Cyrus	WeAreTheMusicMakers
Juno's Touch	WeAreTheMusicMakers
Kevin Sodergren Kottonya	WeAreTheMusicMakers
Linearwave	WeAreTheMusicMakers
Lord Raid	WeAreTheMusicMakers
Mac Murray	WeAreTheMusicMakers
Max Berg	WeAreTheMusicMakers
Michael Wadlow	WeAreTheMusicMakers
Mindseye	WeAreTheMusicMakers
Minerva of the East	WeAreTheMusicMakers
Miss Antidote	WeAreTheMusicMakers
Moxoon	WeAreTheMusicMakers
Nite	WeAreTheMusicMakers
Nomad Noah	WeAreTheMusicMakers
Novel·Fae	WeAreTheMusicMakers
OCD	WeAreTheMusicMakers
Panda Plane	WeAreTheMusicMakers
Pants	WeAreTheMusicMakers
PurNie	WeAreTheMusicMakers
RG	WeAreTheMusicMakers
Reddmond & Joey	WeAreTheMusicMakers
Retrology	WeAreTheMusicMakers
Saros-FM	WeAreTheMusicMakers
Sasori	WeAreTheMusicMakers
Shi-Fi	WeAreTheMusicMakers
Simon Alexander	WeAreTheMusicMakers
So Called People	WeAreTheMusicMakers
Sqrtofneg1	WeAreTheMusicMakers
Sure Matt Sure	WeAreTheMusicMakers
TOUCAN	WeAreTheMusicMakers
The Echo Within	WeAreTheMusicMakers
Timothy	WeAreTheMusicMakers
Tomer	WeAreTheMusicMakers
Trevor Kowalski	WeAreTheMusicMakers
Trippy Ja	WeAreTheMusicMakers
Tyree D.	WeAreTheMusicMakers
Valdemar	WeAreTheMusicMakers
Violet	WeAreTheMusicMakers
Why Not	WeAreTheMusicMakers
Wild Bill Helium	WeAreTheMusicMakers
Yann	WeAreTheMusicMakers
12th Planet	edm
1788-L	edm
3LAU	edm
AC Slater	edm
ALPHA 9	edm
AREA21	edm
ARTY	edm
ATTLAS	edm
Adventure Club	edm
Afrojack	edm
Aly & Fila	edm
Andrew Rayel	edm
Apashe	edm
Axwell	edm
Axwell /\ Ingrosso	edm
Barely Alive	edm
Black Tiger Sex Machine	edm
Blasterjaxx	edm
Boombox Cartel	edm
Borgeous	edm
Botnek	edm
Breathe Carolina	edm
Chris Lake	edm
Cosmic Gate	edm
Curbi	edm
DROELOE	edm
DVBBS	edm
Dabin	edm
Dada Life	edm
Dash Berlin	edm
Dimitri Vangelis & Wyman	edm
Dion Timmer	edm
Dirty South	edm
Dirtyphonics	edm
Don Diablo	edm
Dropgun	edm
DubVision	edm
Dyro	edm
Ekali	edm
Eptic	edm
Excision	edm
Ferry Corsten	edm
Figure	edm
Flosstradamus	edm
G Jones	edm
Gammer	edm
Gentlemens Club	edm
Ghastly	edm
Good Times Ahead	edm
Grant	edm
Grant Bowtie	edm
Gryffin	edm
Hardwell	edm
Hekler	edm
Herobust	edm
ILLENIUM	edm
Ilan Bluestone	edm
JOYRYDE	edm
Jason Ross	edm
Jauz	edm
Jay Hardway	edm
Just A Gent	edm
KRANE	edm
KSHMR	edm
Kasbo	edm
Kayzo	edm
L D R U	edm
LAXX	edm
Lido	edm
Lookas	edm
Lost Kings	edm
Lucas & Steve	edm
MYRNE	edm
Madison Mars	edm
Mako	edm
Malaa	edm
Mark Knight	edm
Markus Schulz	edm
Martin Garrix	edm
Matisse & Sadko	edm
Matroda	edm
Medasin	edm
Mike Williams	edm
MitiS	edm
Moody Good	edm
NERVO	edm
NGHTMRE	edm
Nicky Romero	edm
Notaker	edm
Pierce Fulton	edm
QUIX	edm
Quintino	edm
R3HAB	edm
RIOT	edm
RL Grime	edm
Ray Volpe	edm
Rickyxsan	edm
Robotaki	edm
SLANDER	edm
SLUMBERJACK	edm
Said the Sky	edm
San Holo	edm
Seven Lions	edm
Shades	edm
Shallou	edm
Sick Individuals	edm
Slushii	edm
Snails	edm
Space Laces	edm
Spag Heddy	edm
Steve Angello	edm
Sullivan King	edm
TYNAN	edm
Taska Black	edm
Tchami	edm
The Him	edm
Third Party	edm
Throttle	edm
Timmy Trumpet	edm
Tritonal	edm
TroyBoi	edm
UZ	edm
Ummet Ozcan	edm
Vicetone	edm
Vincent	edm
Vindata	edm
Virtual Riot	edm
W&W	edm
WAVEDASH	edm
Wiwek	edm
Xan Griffin	edm
Zomboy	edm
Zonderling	edm
i_o	edm
josh pan	edm
k?d	edm
soupandreas	edm
1991	electronica
Actress	electronica
Adam Beyer	electronica
Against All Logic	electronica
Alessandro Cortini	electronica
Alice Glass	electronica
Amnesia Scanner	electronica
Andy Stott	electronica
Arca	electronica
Arovane	electronica
Austra	electronica
Autechre	electronica
Baltra	electronica
Basic Channel	electronica
Baths	electronica
Ben Frost	electronica
Bibio	electronica
Bicep	electronica
Biosphere	electronica
Blanck Mass	electronica
Blank Banshee	electronica
Bola	electronica
Boxcutter	electronica
Burial	electronica
Christian Löffler	electronica
Clark	electronica
Classixx	electronica
DJ Koze	electronica
DJ Seinfeld	electronica
Dan Mason ダン·メイソン	electronica
Daniel Avery	electronica
Daphni	electronica
Dauwd	electronica
Deepchord Presents: Echospace	electronica
Deru	electronica
Doctor.Ca	electronica
ESPRIT 空想	electronica
Eluvium	electronica
Fatima Yamaha	electronica
Floating Points	electronica
Forest Swords	electronica
Four Tet	electronica
Freescha	electronica
GAS	electronica
George FitzGerald	electronica
Gridlock	electronica
HNNY	electronica
Herbert	electronica
Holly Herndon	electronica
Idealism	electronica
Iglooghost	electronica
Ital Tek	electronica
JUR X	electronica
James Holden	electronica
Jan Jelinek	electronica
Jeff Wayne	electronica
Jlin	electronica
John Talabot	electronica
Jon Hopkins	electronica
Jordan Maston	electronica
Julio Bashmore	electronica
Jupi/ter	electronica
Kaitlyn Aurelia Smith	electronica
Kelly Lee Owens	electronica
Keos Nabichi	electronica
Kiasmos	electronica
Kink	electronica
Kollektiv Turmstrasse	electronica
Kölsch	electronica
L'Indécis	electronica
Lapalux	electronica
Laurel Halo	electronica
Le Knight Club	electronica
Leon Vynehall	electronica
Lone	electronica
Loscil	electronica
Lusine	electronica
Låpsley	electronica
MDT	electronica
MOVEMENT	electronica
Machinedrum	electronica
Mall Grab	electronica
Maribou State	electronica
Max Cooper	electronica
Midland	electronica
Minilogue	electronica
Mount Kimbie	electronica
Nathan Fake	electronica
Nevermen	electronica
Nicolas Jaar	electronica
Ninetoes	electronica
Nmesh	electronica
Oneohtrix Point Never	electronica
Oval	electronica
Oxia	electronica
Pan-Pot	electronica
Paradis	electronica
Parcels	electronica
Paul Kalkbrenner	electronica
Photay	electronica
Plaid	electronica
Prurient	electronica
Raise	electronica
Recondite	electronica
Rival Consoles	electronica
Rob Mitchelson	electronica
Ross from Friends	electronica
Rrose	electronica
Secede	electronica
Set Fire To Flames	electronica
Shook	electronica
Simian Mobile Disco	electronica
Siriusmo	electronica
Skee Mask	electronica
Skylar Spence	electronica
Soulwax	electronica
Special Request	electronica
Squarepusher	electronica
St Germain	electronica
Stars Of The Lid	electronica
Stephan Bodzin	electronica
Ten Walls	electronica
The Black Dog	electronica
The Bug	electronica
The Field	electronica
The Future Sound Of London	electronica
The I.L.Y's	electronica
Tiago Bettencourt	electronica
Tim Hecker	electronica
Touch Sensitive	electronica
Unito	electronica
Visible Cloaks	electronica
Vivid Shade	electronica
Wagon Christ	electronica
Wankelmut	electronica
Weval	electronica
Zach Hill	electronica
letherette	electronica
µ-Ziq	electronica
２８１４	electronica
199X	Luis Fonsi
DJ Fortify	Luis Fonsi
Dan Salvato	Luis Fonsi
Don't Hug Me I'm Scared	Luis Fonsi
Dylan Locke	Luis Fonsi
EBZ	Luis Fonsi
El Chombo	Luis Fonsi
FISHER	Luis Fonsi
Grandayy	Luis Fonsi
Lil Maxii	Luis Fonsi
Luis Fonsi	Luis Fonsi
Nelix	Luis Fonsi
Oney	Luis Fonsi
Or3o	Luis Fonsi
Party in Backyard	Luis Fonsi
Shoreline Mafia	Luis Fonsi
Sugar Pine 7	Luis Fonsi
Thane	Luis Fonsi
Tones And I	Luis Fonsi
20syl	indietronica
311	indietronica
4hero	indietronica
65daysofstatic	indietronica
99 Souls	indietronica
Absofacto	indietronica
AdhesiveWombat	indietronica
Alan Walker	indietronica
Alina Baraz	indietronica
AllttA	indietronica
Amber Rubarth	indietronica
Amon Tobin	indietronica
Anamanaguchi	indietronica
Animal Collective	indietronica
Aphex Twin	indietronica
Apparat	indietronica
Approaching Nirvana	indietronica
Archive	indietronica
Armand Van Helden	indietronica
Artie Shaw & His New Music	indietronica
Atoms For Peace	indietronica
Audien	indietronica
Avicii	indietronica
BADBADNOTGOOD	indietronica
BROHUG	indietronica
Balam Acab	indietronica
Basement Jaxx	indietronica
Basenji	indietronica
Ben Harper	indietronica
BertycoX	indietronica
Big Black Delta	indietronica
Big Gigantic	indietronica
Billy Bragg	indietronica
Birocratic	indietronica
Black Coast	indietronica
Black Dice	indietronica
Black Moth Super Rainbow	indietronica
Blazo	indietronica
Blue Scholars	indietronica
Blue Sky Black Death	indietronica
Boards of Canada	indietronica
Bob Marley & The Wailers	indietronica
Bobby Caldwell	indietronica
Bonjr	indietronica
Bonobo	indietronica
Braids	indietronica
Breach	indietronica
Breakbot	indietronica
Brock Berrigan	indietronica
Bumpin Uglies	indietronica
C2C	indietronica
Calvin Harris	indietronica
Carbon Based Lifeforms	indietronica
Caribou	indietronica
Carousel	indietronica
Carpenter Brut	indietronica
Celestial Aeon Project	indietronica
Celldweller	indietronica
Chill Bump	indietronica
Chilly Gonzales	indietronica
Chrome Sparks	indietronica
Clap! Clap!	indietronica
Claptone	indietronica
CloZee	indietronica
Colin Stetson	indietronica
Colonel Claypool's Bucket Of Bernie Brains	indietronica
Com Truise	indietronica
Crystal Fighters	indietronica
Crystal Waters	indietronica
DARKSIDE	indietronica
DJ Frane	indietronica
DJ Mehdi	indietronica
DJ Okawari	indietronica
Daft Punk	indietronica
Dan Deacon	indietronica
Dance With the Dead	indietronica
Daniel Bedingfield	indietronica
Datsik	indietronica
Delta Heavy	indietronica
Dennis Ferrer	indietronica
Deorro	indietronica
Detektivbyrån	indietronica
Dibbs	indietronica
Digitalism	indietronica
Dirt Poor Robins	indietronica
Dirty Heads	indietronica
Dirty Vegas	indietronica
Disasterpeace	indietronica
Disclosure	indietronica
Discovery	indietronica
Doctor P	indietronica
Dual Core	indietronica
Duke Dumont	indietronica
Dunderpatrullen	indietronica
Easy Star All-Stars	indietronica
Efence	indietronica
El Huervo	indietronica
Electric Youth	indietronica
Elliot Moss	indietronica
Emancipator	indietronica
Esbe	indietronica
Everything But The Girl	indietronica
Ex Hex	indietronica
FC Kahuna	indietronica
FKJ	indietronica
Faithless	indietronica
Fake Blood	indietronica
Fat Freddy's Drop	indietronica
Fatboy Slim	indietronica
Flamingosis	indietronica
Flight Facilities	indietronica
Fluke	indietronica
Flying Lotus	indietronica
Fuck Buttons	indietronica
FÄIS	indietronica
Galantis	indietronica
Garden City Movement	indietronica
Gas	indietronica
Gesaffelstein	indietronica
Ghostland Observatory	indietronica
Gil Scott-Heron	indietronica
Giorgio Moroder	indietronica
Giraffage	indietronica
Global Communication	indietronica
Goblin	indietronica
Gold Panda	indietronica
GoldFish	indietronica
GoodQue	indietronica
Goodwill	indietronica
Gramatik	indietronica
Gunship	indietronica
GusGus	indietronica
HEALTH	indietronica
Hako Yamazaki	indietronica
Hallucinogen	indietronica
Harry Manfredini	indietronica
Hermitude	indietronica
Hiatus	indietronica
Hiatus Kaiyote	indietronica
Hjálmar	indietronica
Home	indietronica
Hot Chip	indietronica
Hundred Waters	indietronica
IC3PEAK	indietronica
IHF	indietronica
INZO	indietronica
Igorrr	indietronica
Ikimonogakari	indietronica
Inc.	indietronica
Infected Mushroom	indietronica
Inspired Flight	indietronica
Interstellar Noise	indietronica
Jack Ü	indietronica
Jake Chudnow	indietronica
James Blake	indietronica
Jamie xx	indietronica
Jay Sunaway	indietronica
Jean-Michel Jarre	indietronica
Jinsang	indietronica
Joe Hisaishi	indietronica
John Carpenter	indietronica
John Holt	indietronica
Junior Boys	indietronica
Junip	indietronica
Juno Reactor	indietronica
Justice	indietronica
Jutrø	indietronica
Jyr3h	indietronica
Kate Boy	indietronica
Kavinsky	indietronica
Kenny Dope	indietronica
Kero One	indietronica
Kill The Noise	indietronica
Kingsley	indietronica
Klangkarussell	indietronica
Koan	indietronica
Koda	indietronica
Kubbi	indietronica
LEISURE	indietronica
Larytta	indietronica
"Lee ""Scratch"" Perry"	indietronica
Lemaitre	indietronica
Les Sins	indietronica
Little Dragon	indietronica
Little People	indietronica
Long Arm	indietronica
Lorn	indietronica
Lost Frequencies	indietronica
Low Roar	indietronica
Lucy Rose	indietronica
MEUTE	indietronica
MK	indietronica
Made in Heights	indietronica
Madeon	indietronica
Mafalda Veiga	indietronica
Magic Sword	indietronica
Major Lazer	indietronica
Marcus Marr	indietronica
Martin Roth	indietronica
Martin Solveig	indietronica
Masego	indietronica
Matthew Dear	indietronica
Melleefresh	indietronica
Merk & Kremont	indietronica
Miami Horror	indietronica
Michael Hunter	indietronica
Moby	indietronica
Moderat	indietronica
Modestep	indietronica
Modjo	indietronica
Morcheeba	indietronica
Mr. Oizo	indietronica
Mr. Probz	indietronica
Mylo	indietronica
M|O|O|N	indietronica
Møme	indietronica
Neat Beats	indietronica
Neon Indian	indietronica
Nightmares On Wax	indietronica
Nils Frahm	indietronica
Nils Lofgren	indietronica
Nosaj Thing	indietronica
Nuages	indietronica
Nujabes	indietronica
OVERWERK	indietronica
Oliver Tank	indietronica
Om Zho	indietronica
Orbital	indietronica
Ott	indietronica
PNAU	indietronica
Panama	indietronica
Panda Bear	indietronica
Parasyte	indietronica
Parov Stelar	indietronica
Paul Johnson	indietronica
Paul Leonard-Morgan	indietronica
Pendulum	indietronica
Perturbator	indietronica
Pit Z	indietronica
Pold	indietronica
Poolside	indietronica
Porter Robinson	indietronica
Prefuse 73	indietronica
Pretty Lights	indietronica
Proleter	indietronica
Purity Ring	indietronica
RAC	indietronica
Rebelution	indietronica
Rob Dougan	indietronica
Robert Glasper Experiment	indietronica
Robert Miles	indietronica
Robin Schulz	indietronica
Robot Koch	indietronica
Roosevelt	indietronica
Route 94	indietronica
Rudimental	indietronica
Röyksopp	indietronica
S U R V I V E	indietronica
SBTRKT	indietronica
SOHN	indietronica
SOJA	indietronica
Saigon	indietronica
Salem	indietronica
Samiyam	indietronica
Savlonic	indietronica
Scattle	indietronica
Seekae	indietronica
Sep-87	indietronica
Shannon Green	indietronica
Shatter	indietronica
Shawn Wasabi	indietronica
Shigeto	indietronica
Shlohmo	indietronica
Shpongle	indietronica
Skrillex	indietronica
Slightly Stoopid	indietronica
Slugabed	indietronica
Snak The Ripper	indietronica
Solar Fields	indietronica
Sorrow	indietronica
Spiller	indietronica
Starcadian	indietronica
Stellardrone	indietronica
Stephanie Mills	indietronica
Stephen Swartz	indietronica
Stick Figure	indietronica
Submotion Orchestra	indietronica
Summer Heart	indietronica
Supermode	indietronica
Swearr	indietronica
Swedish House Mafia	indietronica
Sweet Valley	indietronica
Sylvan Esso	indietronica
TOBACCO	indietronica
Ta-ku	indietronica
Tangerine Dream	indietronica
Taylor McFerrin	indietronica
Telefon Tel Aviv	indietronica
The Acid	indietronica
The Black Queen	indietronica
The Blaze	indietronica
The Books	indietronica
The Chemical Brothers	indietronica
The Correspondents	indietronica
The Crystal Method	indietronica
The Doobie Brothers	indietronica
The Glitch Mob	indietronica
The Griswolds	indietronica
The Magician	indietronica
The Merry Macs	indietronica
The Midnight	indietronica
The Platters	indietronica
The Prodigy	indietronica
The Samples	indietronica
The Shanghai Restoration Project	indietronica
The Shapeshifters	indietronica
The Toxic Avenger	indietronica
The Very Best	indietronica
The Winstons	indietronica
Thievery Corporation	indietronica
Thieves Like Us	indietronica
Thundercat	indietronica
Tiga	indietronica
Tipper	indietronica
Todd Terje	indietronica
Tokoyo	indietronica
Tom Misch	indietronica
Tomppabeats	indietronica
Too Many Zooz	indietronica
Tor	indietronica
Toro y Moi	indietronica
Trazan & Banarne	indietronica
Trifonic	indietronica
Two Feet	indietronica
Tycho	indietronica
Télépopmusik	indietronica
Ulrich Schnauss	indietronica
Underworld	indietronica
Uppermost	indietronica
Uyama Hiroto	indietronica
Valentino Khan	indietronica
Vangelis	indietronica
Vanilla	indietronica
Venetian Snares	indietronica
View	indietronica
Vitalic	indietronica
WHY?	indietronica
Washed Out	indietronica
We Are All Astronauts	indietronica
Webbstur	indietronica
Wesk	indietronica
White Ring	indietronica
William Bell	indietronica
William Fitzsimmons	indietronica
Wolfgang Gartner	indietronica
Xavier Rudd	indietronica
YELLOW MAGIC ORCHESTRA	indietronica
Years Apart	indietronica
Yeasayer	indietronica
Yosi Horikawa	indietronica
Younger Brother	indietronica
Yu-Utsu	indietronica
Yuna	indietronica
Zedd	indietronica
bôa	indietronica
edIT	indietronica
grandson	indietronica
iamamiwhoami	indietronica
trentemøller	indietronica
xxyyxx	indietronica
Éric Serra	indietronica
Ørdop Wolkenscheidt	indietronica
22	progressive metal
Agent Fresco	progressive metal
An Endless Sporadic	progressive metal
Anders Björler	progressive metal
Arch Echo	progressive metal
Artificial Language	progressive metal
Ashley Tisdale	progressive metal
Ayreon	progressive metal
Between The Buried And Me	progressive metal
Caligula's Horse	progressive metal
Car Bomb	progressive metal
Caravan	progressive metal
Cloudkicker	progressive metal
Corelia	progressive metal
Disperse	progressive metal
Distorted Harmony	progressive metal
Earthside	progressive metal
Gazpacho	progressive metal
Gentle Giant	progressive metal
Guilt Machine	progressive metal
Haken	progressive metal
I, Omega	progressive metal
Intronaut	progressive metal
Kayo Dot	progressive metal
Leprous	progressive metal
Moon Tooth	progressive metal
Native Construct	progressive metal
Night Verses	progressive metal
OSI	progressive metal
Pomegranate Tiger	progressive metal
Rivers of Nihil	progressive metal
SikTh	progressive metal
Skyharbor	progressive metal
Soen	progressive metal
TesseracT	progressive metal
Textures	progressive metal
The Contortionist	progressive metal
The Helix Nebula	progressive metal
The Human Abstract	progressive metal
The Lowbrow	progressive metal
The Ocean	progressive metal
The Pineapple Thief	progressive metal
VOLA	progressive metal
Vildhjarta	progressive metal
Voyager	progressive metal
257ers	european
Alligatoah	european
Amanda Bergman	european
Angèle	european
AnnenMayKantereit	european
Antilopen Gang	european
Bilderbuch	european
Bomba Estéreo	european
Boogarins	european
Café Tacvba	european
Camille	european
Casper	european
Charles Aznavour	european
Chico Buarque	european
Chinese Man	european
Chris Knox	european
Dance Exponents	european
De Jeugd Van Tegenwoordig	european
Diabo Na Cruz	european
Die Ärzte	european
Diogo Piçarra	european
Ebba Grön	european
Eivør	european
Eleni Foureira	european
Faun	european
Focus and Attention	european
Folke Nikanor	european
Francesca Michielin	european
Frank Sartain	european
Gipsy Kings	european
Hannes Wader	european
Heilung	european
Hency	european
Horseshoe G.A.N.G.	european
Horslips	european
Jacques Brel	european
Jenni Vartiainen	european
Jesse & Joy	european
Johnny Clegg & Juluka	european
Joint Venture	european
Jättedam	european
K.I.Z	european
Karpe	european
Key Glock	european
Kojaque	european
L'Impératrice	european
La Femme	european
Las Ketchup	european
Lil Kleine	european
Lordi	european
Loreena McKennitt	european
Los Del Rio	european
Lô Borges	european
MC Fioti	european
Madcon	european
Mc Solaar	european
Me & My	european
Michael Gray	european
Mo-Do	european
Modena City Ramblers	european
Molotov	european
Moonspell	european
Myd	european
Måns Zelmerlöw	european
Noir Désir	european
Nucleya	european
O-Zone	european
Olive	european
Orelsan	european
Piersi	european
Pixie Paris	european
Planxty	european
RIN	european
Raul Seixa	european
Rodrigo Amarante	european
SSIO	european
SXTN	european
Safri Duo	european
Salvador Sobral	european
Siakol	european
Six Missing	european
Skeptics	european
Soda Stereo	european
Spinvis	european
Supergroove	european
TACONAFIDE	european
TOLEDO	european
The Rasmus	european
Tocotronic	european
Two Hours Traffic	european
Vendredi sur Mer	european
Wardruna	european
Wild Cherry	european
Wise Guys	european
Yung Hurn	european
Zemfira	european
kent	european
2Pac	famous rap
A Tribe Called Red	famous rap
Abhi The Nomad	famous rap
Aceyalone	famous rap
Adam Sandler	famous rap
Aesop Rock	famous rap
Al B. Sure!	famous rap
Alex Starwoda	famous rap
Ann Peebles	famous rap
Atmosphere	famous rap
Azet	famous rap
Bad Meets Evil	famous rap
Bangs	famous rap
Bert Hearns	famous rap
Big Grams	famous rap
Black Eyed Peas	famous rap
Black Sheep	famous rap
Blackstreet	famous rap
Bliss n Eso	famous rap
Bone Thugs-N-Harmony	famous rap
Boogie Down Productions	famous rap
Brother Ali	famous rap
Cam Meekins	famous rap
Cautious Clay	famous rap
Ceschi	famous rap
Charli Baltimore	famous rap
Childish Gambino	famous rap
Classified	famous rap
Clout Goku	famous rap
Control Machete	famous rap
Cypress Hill	famous rap
D'Angelo	famous rap
DJ Format	famous rap
DJ Max Star	famous rap
DJ Shadow	famous rap
Damian Marley	famous rap
Danger Doom	famous rap
Deltron 3030	famous rap
Dessa	famous rap
Digable Planets	famous rap
Dizzee Rascal	famous rap
Doomtree	famous rap
Dr. Dre	famous rap
Dr. Octagon	famous rap
Eazy-E	famous rap
Eminem	famous rap
Erick Sermon	famous rap
Eyedea & Abilities	famous rap
Fat Joe	famous rap
Fatlip	famous rap
Fela Kuti	famous rap
Fetty Wap	famous rap
From the Flora	famous rap
Fugees	famous rap
Futuristic	famous rap
G Herbo	famous rap
GZA	famous rap
Ghostemane	famous rap
Goodbye Tomorrow	famous rap
Green River Ordinance	famous rap
Grieves	famous rap
Hail Mary Mallon	famous rap
Handsome Boy Modeling School	famous rap
Hilltop Hoods	famous rap
Hippiesindawoodz	famous rap
Hugh Masekela	famous rap
Ice-T	famous rap
Jacob Banks	famous rap
Jidenna	famous rap
Joyner Lucas	famous rap
Jurassic 5	famous rap
Kanye West	famous rap
Kid Cudi	famous rap
Koi Child	famous rap
Labi Siffre	famous rap
Leon DeChino	famous rap
Lil Dicky	famous rap
Lil Nas X	famous rap
Lucius	famous rap
M.I.A.	famous rap
MC Paul Barman	famous rap
Macklemore	famous rap
Mark Wahlberg	famous rap
Matt Ox	famous rap
Maxwell	famous rap
Ms. Lauryn Hill	famous rap
N.A.S.A.	famous rap
N.A.S.P.	famous rap
N.W.A.	famous rap
NF	famous rap
NIKI	famous rap
Naughty By Nature	famous rap
Necro	famous rap
Noj	famous rap
Old Man Saxon	famous rap
Oliver Tree	famous rap
Omega	famous rap
OutKast	famous rap
P.O.S	famous rap
PEZ	famous rap
Peake	famous rap
Pete Rock & C.L. Smooth	famous rap
Prof	famous rap
Public Enemy	famous rap
Queen Latifah	famous rap
Ray Charles	famous rap
Rich Brian	famous rap
Roy Jones Jr.	famous rap
Run The Jewels	famous rap
Sam Roberts Band	famous rap
Shirt	famous rap
Simple Citizens	famous rap
Sister Nancy	famous rap
Slick Rick	famous rap
Solillaquists of Sound	famous rap
SonReal	famous rap
Soulja Boy	famous rap
Starlito	famous rap
Steve Lacy	famous rap
Svi na pod	famous rap
Tank and The Bangas	famous rap
Tech N9ne Collabos	famous rap
The Moth & The Flame	famous rap
The Streets	famous rap
The Uncluded	famous rap
The White Mandingos	famous rap
Tobe Nwigwe	famous rap
Tom Scott	famous rap
Tommy Cash	famous rap
Too $hort	famous rap
Viper	famous rap
Warren G	famous rap
Watsky	famous rap
Wax	famous rap
Witt Lowry	famous rap
Wu-Tang Clan	famous rap
YEAR OF THE OX	famous rap
Yelawolf	famous rap
Yellowman	famous rap
Young Dro	famous rap
Yung Chef	famous rap
bLAck pARty	famous rap
nothing,nowhere.	famous rap
thegoodnews.	famous rap
40 Watt Sun	doom metal
Aborted	doom metal
Agony by Default	doom metal
Ahab	doom metal
Altar Of Plagues	doom metal
Amesoeurs	doom metal
Archspire	doom metal
At The Gates	doom metal
Atheist	doom metal
Bathory	doom metal
Be'lakor	doom metal
Bell Witch	doom metal
Beyond Creation	doom metal
Bongripper	doom metal
Borknagar	doom metal
Candlemass	doom metal
Carcass	doom metal
Conan	doom metal
Coroner	doom metal
Deicide	doom metal
Doomsword	doom metal
Dream Death	doom metal
Drudkh	doom metal
Dying Fetus	doom metal
Dyscarnate	doom metal
Elder	doom metal
Enslaved	doom metal
Exivious	doom metal
Eyehategod	doom metal
Fates Warning	doom metal
Ghost Brigade	doom metal
Goatwhore	doom metal
Gorgoroth	doom metal
Gorguts	doom metal
Grift	doom metal
Harakiri for the Sky	doom metal
Hath	doom metal
High On Fire	doom metal
Holy Terror	doom metal
Ihsahn	doom metal
Immolation	doom metal
Immortal	doom metal
In My Embrace	doom metal
Irreversible Mechanism	doom metal
Jess and the Ancient Ones	doom metal
Job For A Cowboy	doom metal
Kalmah	doom metal
Kataklysm	doom metal
Khemmis	doom metal
Kvist	doom metal
Metal Church	doom metal
Midnight	doom metal
Midnight Odyssey	doom metal
Monolord	doom metal
Morbid Angel	doom metal
Mount Salem	doom metal
Necrophobic	doom metal
Nile	doom metal
Noumena	doom metal
Novembers Doom	doom metal
Omega Diatribe	doom metal
Omnium Gatherum	doom metal
Oranssi Pazuzu	doom metal
Pagan Altar	doom metal
Pallbearer	doom metal
Paysage D'Hiver	doom metal
Persefone	doom metal
Possessed	doom metal
Psycroptic	doom metal
Revocation	doom metal
Ripping Corpse	doom metal
Roadrunner United	doom metal
Saint Vitus	doom metal
Scar Symmetry	doom metal
Shade Empire	doom metal
Shrinebuilder	doom metal
Sigh	doom metal
Skeletonwitch	doom metal
Soilwork	doom metal
Sortilège	doom metal
SubRosa	doom metal
Sulphur Aeon	doom metal
Summoning	doom metal
Swallow The Sun	doom metal
Sylosis	doom metal
Tankard	doom metal
Testament	doom metal
The Black Dahlia Murder	doom metal
The Body	doom metal
The Faceless	doom metal
The Lord Weird Slough Feg	doom metal
Thou	doom metal
Thy Catafalque	doom metal
Trepalium	doom metal
Triptykon	doom metal
Trouble	doom metal
Two Legs	doom metal
Vektor	doom metal
Vio-Lence	doom metal
Voivod	doom metal
Warhorse	doom metal
Windhand	doom metal
Witchfinder General	doom metal
Witherscape	doom metal
Wolfheart	doom metal
Wolves In The Throne Room	doom metal
YOB	doom metal
5 Seconds of Summer	pop2
ABRA	pop2
Against The Current	pop2
Aly & AJ	pop2
Amy Shark	pop2
Anitta	pop2
Anna of the North	pop2
Anne-Marie	pop2
Ansel Elgort	pop2
Aquilo	pop2
Astrid S	pop2
Bazzi	pop2
Bebe Rexha	pop2
Ben Khan	pop2
Busted	pop2
Camila Cabello	pop2
Charli XCX	pop2
Charlie Puth	pop2
Chelsea Jade	pop2
Cheryl	pop2
Chloe x Halle	pop2
Clean Bandit	pop2
Cruel Youth	pop2
DNCE	pop2
Danny L Harle	pop2
Daya	pop2
Demi Lovato	pop2
Dua Lipa	pop2
EASYFUN	pop2
Ella Mai	pop2
Emeli Sandé	pop2
Emma Blackery	pop2
Empress Of	pop2
Foxes	pop2
GFOTY	pop2
Gabrielle Aplin	pop2
George Ezra	pop2
Ghosted	pop2
Girls Aloud	pop2
Grace VanderWaal	pop2
Hannah Diamond	pop2
Hayley Kiyoko	pop2
Hey Violet	pop2
Icona Pop	pop2
Japanese Breakfast	pop2
Jax Jones	pop2
Jessie J	pop2
Kacy Hill	pop2
Kailee Morgue	pop2
Karmin	pop2
Kehlani	pop2
Kelela	pop2
Kidz Bop Kids	pop2
Kilo Kish	pop2
King Princess	pop2
LA Project	pop2
LANY	pop2
Lauv	pop2
Le1f	pop2
Litany	pop2
Little Mix	pop2
Maggie Rogers	pop2
Maren Morris	pop2
Marsicans	pop2
Miranda Cosgrove	pop2
Miya Folick	pop2
Nao	pop2
Nick Jonas	pop2
Nicola Roberts	pop2
Nicole Millar	pop2
Nile Rodgers	pop2
Noah Cyrus	pop2
Paris Hilton	pop2
Poppy	pop2
Rachel Platten	pop2
Rita Ora	pop2
SOPHIE	pop2
Sam Smith	pop2
Sasha Sloan	pop2
Scottie Kash	pop2
Selena Gomez	pop2
Sevdaliza	pop2
Shawn Mendes	pop2
Sigrid	pop2
Ssion	pop2
Terror Jr	pop2
The Aces	pop2
Thomas Rhett	pop2
Tori Kelly	pop2
Tove Styrke	pop2
Troye Sivan	pop2
Vanessa Hudgens	pop2
XYLØ	pop2
Yanni	pop2
Yasutaka Nakata	pop2
Yelle	pop2
ZAYN	pop2
Zara Larsson	pop2
cupcakKe	pop2
ionnalee	pop2
50 Cent	rap
6ix9ine	rap
8-Off Agallah Featuring Sean Price & Bazaar Royale	rap
88rising	rap
A Tribe Called Quest	rap
A$AP Mob	rap
A$AP Rocky	rap
Above The Law	rap
Action Bronson	rap
Akon	rap
Aminé	rap
Anderson .Paak	rap
Andy Mineo	rap
Angel Haze	rap
Anna Wise	rap
Anton's Key	rap
Apathy	rap
Aries	rap
Astonish	rap
BOOTS	rap
BROCKHAMPTON	rap
Bad Bunny	rap
Bear	rap
Bhad Bhabie	rap
Big L	rap
Big Pun	rap
Big Sean	rap
Binary Star	rap
Black Star	rap
Blackway	rap
BlocBoy JB	rap
Bobby Shmurda	rap
Brian Witzig	rap
Brotha Lynch Hung	rap
Bryson Tiller	rap
Busdriver	rap
CYNE	rap
Cage	rap
Cakes da Killa	rap
Cannibal Ox	rap
Chance the Rapper	rap
Chingy	rap
Chris Brown	rap
Clams Casino	rap
Collin McLoughlin	rap
Common	rap
Company Flow	rap
Cool Calm Pete	rap
Corbin	rap
Cortex	rap
Craig Mack	rap
Cunninlynguists	rap
Curt De Smoke	rap
DJ Rashad	rap
DRAM	rap
DaBaby	rap
Dabrye	rap
Daedelus	rap
Daniel Caesar	rap
Danny Brown	rap
Dbangz	rap
De La Soul	rap
Death Grips	rap
Deca	rap
Del The Funky Homosapien	rap
Desiigner	rap
Deuce	rap
Diddy	rap
Dilated Peoples	rap
Donnie Trumpet & The Social Experiment	rap
Drake	rap
Drake Bell	rap
Dumbfoundead	rap
Dutchman	rap
Dylan Wild	rap
E-40	rap
EPMD	rap
Eagles	rap
Earl Sweatshirt	rap
Edan	rap
El-P	rap
Eligh	rap
Eric B. & Rakim	rap
Erykah Badu	rap
Evidenc-E	rap
FUTURE WHIRL	rap
Fame on Fire	rap
Fashawn	rap
Foliage	rap
Francis and the Lights	rap
Frank Ocean	rap
French Montana	rap
G-Eazy	rap
Gang Starr	rap
Ghostpoet	rap
Gonjasufi	rap
Gravediggaz	rap
Guru	rap
H.E.R.	rap
Hallucinogenius	rap
Higher Brothers	rap
Ho99o9	rap
Homeboy Sandman	rap
Hopsin	rap
Ivan Ave	rap
J Dilla	rap
J. Cole	rap
JAY-Z	rap
JJ DOOM	rap
JMSN	rap
JOJI	rap
JPEGMAFIA	rap
Jaden	rap
Jalen Santoy	rap
Jamila Woods	rap
Jedi Mind Tricks	rap
Jeremih	rap
Jhené Aiko	rap
Jme	rap
Johnny och Lillemor	rap
Joji	rap
Jorja Smith	rap
Joryj Kłoc	rap
Ju$tin	rap
Juice WRLD	rap
Juicy J	rap
K'NAAN	rap
KAYTRANADA	rap
KRS-One	rap
KSI	rap
KYLE	rap
Kali Uchis	rap
Kano	rap
Kendrick Lamar	rap
Keri Hilson	rap
Kevin Abstract	rap
Khalid	rap
Kris Wu	rap
Kweku Collins	rap
Leak Bros	rap
Lecrae	rap
Leikeli47	rap
Lil B	rap
Lil Keke	rap
Lil Pump	rap
Lil Toe	rap
Lil Wayne	rap
Lil Windex	rap
Lil Xan	rap
Lloyd	rap
Logic	rap
Lords Of The Underground	rap
Loyle Carner	rap
Ludacris	rap
Lupe Fiasco	rap
M.R.Clankz	rap
MF DOOM	rap
MJx Music	rap
Machine Gun Kelly	rap
Madlib	rap
Madvillain	rap
Major Accident	rap
Malibu Ken	rap
Michael Christmas	rap
Migos	rap
Miguel	rap
Mike Jones	rap
Milo	rap
Missy Elliott	rap
Mndsgn	rap
Mobb Deep	rap
Molemen	rap
Mos Def	rap
N.E.R.D	rap
N.O.R.E.	rap
NAIVE	rap
Nacho Picasso	rap
Nas	rap
"Nas & Damian ""Jr. Gong"" Marley"	rap
Nehruviandoom	rap
Nicki Minaj	rap
Night Lovell	rap
Noname	rap
O.E.	rap
OG Maco	rap
Ocean Wisdom	rap
Oddisee	rap
Offset	rap
Oh No	rap
Onra	rap
Open Mike Eagle	rap
PNL	rap
Paolo Sandejas	rap
Philadelphia Slick	rap
Phive 6	rap
Phony Ppl	rap
Post Malone	rap
Princess Nokia	rap
Quasimoto	rap
Rae Sremmurd	rap
Raury	rap
Ravyn Lenae	rap
Redman	rap
Rich Gang	rap
Rich Homie Quan	rap
Riff Raff	rap
Rob $tone	rap
Robert Palmer	rap
Roddy Ricch	rap
Ruby Ibarra	rap
Russ	rap
Rustie	rap
SZA	rap
Sampha	rap
Saturn Will Not Sleep	rap
Sauce Walka	rap
Sawbé	rap
ScHoolboy Q	rap
Scarface	rap
Shabazz Palaces	rap
Shad	rap
Shahmen	rap
Shakewell	rap
Sheck Wes	rap
Shredders	rap
Skepta	rap
Snoop Dogg	rap
Sol	rap
Souls Of Mischief	rap
Spooky Black	rap
Spose	rap
Stainless Steele	rap
Stefflon Don	rap
Stormzy	rap
Suicideyear	rap
Superchunk	rap
Swet Shop Boys	rap
Syd	rap
T-Pain	rap
T.I.	rap
THEY.	rap
TNGHT	rap
TOKiMONSTA	rap
Tech N9ne	rap
The Brass	rap
The Carters	rap
The Cool Kids	rap
The Encounter	rap
The Exploited	rap
The Four Owls	rap
The Game	rap
The Good Life	rap
The Internet	rap
The Notorious B.I.G.	rap
The Pharcyde	rap
The Roots	rap
The Weeknd	rap
The-Dream	rap
Theophilus London	rap
Token	rap
Triple One	rap
Twista	rap
Tyga	rap
Tyler, The Creator	rap
UGK	rap
Ugly God	rap
UnoTheActivist	rap
VTA	rap
Vic Mensa	rap
Vince Staples	rap
Waka Flocka Flame	rap
Weaver Beats	rap
Will Smith	rap
XXXTENTACION	rap
YG	rap
YNW Melly	rap
Yeti Ghetto	rap
Young M.A	rap
Young Money	rap
Yung Gravy	rap
Yung Lean	rap
Z-Ro	rap
at Wendys	rap
benny blanco	rap
clipping.	rap
dvsn	rap
ets Amazin!	rap
mansionz	rap
tobi lou	rap
zack villere	rap
727's	neo-psychedelic
A Presença das Formigas	neo-psychedelic
A Winged Victory for the Sullen	neo-psychedelic
Alex G	neo-psychedelic
All Them Witches	neo-psychedelic
Allah-Las	neo-psychedelic
Allen Toussaint	neo-psychedelic
Anaquim	neo-psychedelic
And So I Watch You from Afar	neo-psychedelic
Anna von Hausswolff	neo-psychedelic
António Zambujo	neo-psychedelic
Ararur	neo-psychedelic
Asobi Seksu	neo-psychedelic
Asteroid	neo-psychedelic
Aura Blaze	neo-psychedelic
Autolux	neo-psychedelic
Autre Ne Veut	neo-psychedelic
Balmorhea	neo-psychedelic
Baltimore	neo-psychedelic
Bauhaus	neo-psychedelic
Beak>	neo-psychedelic
Beat Driven Insomnia	neo-psychedelic
Bells	neo-psychedelic
Benoît Pioulard	neo-psychedelic
Black Mountain	neo-psychedelic
Blood Cultures	neo-psychedelic
Brady Mann	neo-psychedelic
Branko	neo-psychedelic
Brightblack Morning Light	neo-psychedelic
Broadcast	neo-psychedelic
Bruce Haack	neo-psychedelic
CAN	neo-psychedelic
Candy Claws	neo-psychedelic
Capitão Fausto	neo-psychedelic
Carmen McRae	neo-psychedelic
Carminho	neo-psychedelic
Causa Sui	neo-psychedelic
Cave	neo-psychedelic
Cavves	neo-psychedelic
Ceramic Animal	neo-psychedelic
Chaka Khan	neo-psychedelic
Chess at Breakfast	neo-psychedelic
Chicano Batman	neo-psychedelic
Chinese Football	neo-psychedelic
Chris Del Mar	neo-psychedelic
Chris Litwa	neo-psychedelic
Church of the Cosmic Skull	neo-psychedelic
Clever Girl	neo-psychedelic
Clio	neo-psychedelic
Colour Haze	neo-psychedelic
Connan Mockasin	neo-psychedelic
Covet	neo-psychedelic
Craig Meighan	neo-psychedelic
Cristina Branco	neo-psychedelic
Cuca Roseta	neo-psychedelic
Céu	neo-psychedelic
D'alva	neo-psychedelic
DILLY DALLY	neo-psychedelic
Daughters	neo-psychedelic
Dave Bixby	neo-psychedelic
Dead Meadow	neo-psychedelic
Defective Sounds of London	neo-psychedelic
Delta Sleep	neo-psychedelic
Deolinda	neo-psychedelic
Do Make Say Think	neo-psychedelic
Don Caballero	neo-psychedelic
Dorothy Ashby	neo-psychedelic
Dumbo Gets Mad	neo-psychedelic
Dungen	neo-psychedelic
Duster	neo-psychedelic
Dâm-Funk	neo-psychedelic
Eddie Hazel	neo-psychedelic
Emitt Rhodes	neo-psychedelic
Eugene McDaniels	neo-psychedelic
Fathers Children	neo-psychedelic
Faust	neo-psychedelic
Fishmans	neo-psychedelic
Francis Bebey	neo-psychedelic
From Autumn To Ashes	neo-psychedelic
Fuzz	neo-psychedelic
Galaxie 500	neo-psychedelic
Games	neo-psychedelic
Gang Gang Dance	neo-psychedelic
Gang Of Four	neo-psychedelic
George Clanton	neo-psychedelic
Gisela João	neo-psychedelic
Goat	neo-psychedelic
God Is An Astronaut	neo-psychedelic
Grails	neo-psychedelic
Greenleaf	neo-psychedelic
Grouper	neo-psychedelic
Guster	neo-psychedelic
HOMESHAKE	neo-psychedelic
Hammock	neo-psychedelic
Hard N Low	neo-psychedelic
Hella	neo-psychedelic
Holy Ghost!	neo-psychedelic
How To Dress Well	neo-psychedelic
If These Trees Could Talk	neo-psychedelic
Industries of the Blind	neo-psychedelic
Isotope 217	neo-psychedelic
Izzy Scared	neo-psychedelic
JYOCHO	neo-psychedelic
Jakob	neo-psychedelic
Japancakes	neo-psychedelic
Joana Espadinha	neo-psychedelic
Jon Wilks	neo-psychedelic
Joni Mitchell	neo-psychedelic
Juana Molina	neo-psychedelic
Jónsi & Alex	neo-psychedelic
Kadavar	neo-psychedelic
Kairon; IRSE!	neo-psychedelic
Khruangbin	neo-psychedelic
Kim Jung Mi	neo-psychedelic
King Buffalo	neo-psychedelic
King Dude	neo-psychedelic
King Gizzard & The Lizard Wizard	neo-psychedelic
LITE	neo-psychedelic
Langhorne Slim	neo-psychedelic
Linda Martini	neo-psychedelic
Long Distance Calling	neo-psychedelic
Lost Notes Society	neo-psychedelic
Lotus Plaza	neo-psychedelic
Love	neo-psychedelic
Luis Peixoto	neo-psychedelic
Luna Gala	neo-psychedelic
Lush	neo-psychedelic
MONO	neo-psychedelic
Madrepaz	neo-psychedelic
Mariah	neo-psychedelic
Mariza	neo-psychedelic
Mark Lanegan	neo-psychedelic
Mars Red Sky	neo-psychedelic
Marta Pereira da Costa	neo-psychedelic
Maximum Impulse Sound System	neo-psychedelic
Maybeshewill	neo-psychedelic
Meko Supreme	neo-psychedelic
Melody's Echo Chamber	neo-psychedelic
Memimo Tuati	neo-psychedelic
Mercury Rev	neo-psychedelic
Miguel Araújo	neo-psychedelic
Mild High Club	neo-psychedelic
Moodoïd	neo-psychedelic
Morgen	neo-psychedelic
Mr Twin Sister	neo-psychedelic
My Sleeping Karma	neo-psychedelic
Mystic Braves	neo-psychedelic
Márcia	neo-psychedelic
NBC	neo-psychedelic
NEU!	neo-psychedelic
Night Beds	neo-psychedelic
No Joy	neo-psychedelic
Noiserv	neo-psychedelic
Nyre	neo-psychedelic
Oh Hiroshima	neo-psychedelic
Oppenheimer Analysis	neo-psychedelic
Orchards	neo-psychedelic
Orchestral Manoeuvres In The Dark	neo-psychedelic
Os Velhos	neo-psychedelic
PZ	neo-psychedelic
Palace Music	neo-psychedelic
Paus	neo-psychedelic
Pepe Deluxe	neo-psychedelic
Polvo	neo-psychedelic
Pond	neo-psychedelic
Pretend	neo-psychedelic
Psychedelic Porn Crumpets	neo-psychedelic
Pulse Modulators	neo-psychedelic
Quicksilver Messenger Service	neo-psychedelic
Quilll	neo-psychedelic
Radio Moscow	neo-psychedelic
Raquel Tavares	neo-psychedelic
Red Sparowes	neo-psychedelic
Ride	neo-psychedelic
Salto	neo-psychedelic
Samsara Blues Experiment	neo-psychedelic
Samuel Uria	neo-psychedelic
Savages	neo-psychedelic
Show Me the Body	neo-psychedelic
Silver Mt. Zion	neo-psychedelic
Siouxsie and the Banshees	neo-psychedelic
Skinshape	neo-psychedelic
Soft Hair	neo-psychedelic
Sonic Youth	neo-psychedelic
Spaceslug	neo-psychedelic
Sparks	neo-psychedelic
Spindrift	neo-psychedelic
Stark Reality	neo-psychedelic
Stoned Jesus	neo-psychedelic
Strawberry Girls	neo-psychedelic
Subway Sect	neo-psychedelic
Suicide	neo-psychedelic
Summer Like the Season	neo-psychedelic
Sweet Trip	neo-psychedelic
TG Lurgan	neo-psychedelic
Tamaryn	neo-psychedelic
Tellurian	neo-psychedelic
Temples	neo-psychedelic
The 13th Floor Elevators	neo-psychedelic
The Barren Gods	neo-psychedelic
The Beta Band	neo-psychedelic
The Brian Jonestown Massacre	neo-psychedelic
The Calm Blue Sea	neo-psychedelic
The Chameleons	neo-psychedelic
The Claypool Lennon Delirium	neo-psychedelic
The Evpatoria Report	neo-psychedelic
The Fall	neo-psychedelic
The Family Crest	neo-psychedelic
The Feelies	neo-psychedelic
The GOASTT (The Ghost Of A Saber Tooth Tiger)	neo-psychedelic
The Gay Brownie Boys	neo-psychedelic
The Go-Betweens	neo-psychedelic
The Grizzly Folk	neo-psychedelic
The Jesus and Mary Chain	neo-psychedelic
The Modern Lovers	neo-psychedelic
The Olivia Tremor Control	neo-psychedelic
The Organ	neo-psychedelic
The Physics House Band	neo-psychedelic
The Range	neo-psychedelic
The Raveonettes	neo-psychedelic
The Sound	neo-psychedelic
The Sugarcubes	neo-psychedelic
The Twilight Sad	neo-psychedelic
The United States Of America	neo-psychedelic
The Wolves of Chernobyl	neo-psychedelic
Thee Oh Sees	neo-psychedelic
This Will Destroy You	neo-psychedelic
Three Trapped Tigers	neo-psychedelic
Throwing Muses	neo-psychedelic
Tides From Nebula	neo-psychedelic
Tides Of Man	neo-psychedelic
Tommy Jesus	neo-psychedelic
Tortoise	neo-psychedelic
Totorro	neo-psychedelic
Toundra	neo-psychedelic
Tricky	neo-psychedelic
True Widow	neo-psychedelic
Twinsmith	neo-psychedelic
Ty Segall Band	neo-psychedelic
Ultrasound Express	neo-psychedelic
Um Corpo Estranho	neo-psychedelic
Vinyl Williams	neo-psychedelic
Viviane	neo-psychedelic
WU LYF	neo-psychedelic
Walter TV	neo-psychedelic
Wand	neo-psychedelic
We Lost The Sea	neo-psychedelic
William Onyeabor	neo-psychedelic
Witch	neo-psychedelic
Witchcraft	neo-psychedelic
Wolf People	neo-psychedelic
Yndi Halda	neo-psychedelic
Young Fathers	neo-psychedelic
Young Marble Giants	neo-psychedelic
mouse on the keys	neo-psychedelic
múm	neo-psychedelic
sleepmakeswaves	neo-psychedelic
toe	neo-psychedelic
A Day To Remember	metalcore
A Lot Like Birds	metalcore
A Skylit Drive	metalcore
Abandon All Ships	metalcore
Alesana	metalcore
Alexisonfire	metalcore
All That Remains	metalcore
Architects	metalcore
As Cities Burn	metalcore
As I Lay Dying	metalcore
Asking Alexandria	metalcore
Atreyu	metalcore
Attack Attack!	metalcore
Attila	metalcore
August Burns Red	metalcore
Beartooth	metalcore
Betraying The Martyrs	metalcore
Black Peaks	metalcore
Botch	metalcore
Bring Me The Horizon	metalcore
Bullet For My Valentine	metalcore
Capstan	metalcore
Chiodos	metalcore
Code Orange	metalcore
Comeback Kid	metalcore
Converge	metalcore
CrazyEightyEight	metalcore
Crossfaith	metalcore
Dance Gavin Dance	metalcore
Dangerkids	metalcore
Dayseeker	metalcore
Demon Hunter	metalcore
Eidola	metalcore
Emarosa	metalcore
Escape the Fate	metalcore
Eskimo Callboy	metalcore
Every Time I Die	metalcore
Extermination Dismemberment	metalcore
FEVER 333	metalcore
Falling In Reverse	metalcore
Fire From The Gods	metalcore
Gangrene	metalcore
Glassjaw	metalcore
Glasslands	metalcore
Gospel	metalcore
Hail The Sun	metalcore
Hands Like Houses	metalcore
He Is Legend	metalcore
Hellions	metalcore
Hopesfall	metalcore
Hundredth	metalcore
I See Stars	metalcore
I The Mighty	metalcore
Ice Nine Kills	metalcore
Impending Doom	metalcore
Incendiary	metalcore
Infant Annihilator	metalcore
Isles & Glaciers	metalcore
Issues	metalcore
Jared Dines	metalcore
Killswitch Engage	metalcore
Knocked Loose	metalcore
Michael Barr	metalcore
Of Mice & Men	metalcore
Our Last Night	metalcore
Parkway Drive	metalcore
People Under The Stairs	metalcore
Pharoahe Monch	metalcore
Picturesque	metalcore
Pierce The Veil	metalcore
Poison The Well	metalcore
Rise Of The Northstar	metalcore
Rolo Tomassi	metalcore
Saosin	metalcore
Scary Kids Scaring Kids	metalcore
Secret & Whisper	metalcore
Secret Band	metalcore
Sianvar	metalcore
Silverstein	metalcore
Sleeping With Sirens	metalcore
Suicide Silence	metalcore
Sylar	metalcore
The Amity Affliction	metalcore
The Armed	metalcore
The Browning	metalcore
The Ghost Inside	metalcore
The Ongoing Concept	metalcore
The Venetia Fair	metalcore
The White Noise	metalcore
Thursday	metalcore
Thy Art Is Murder	metalcore
Tilian	metalcore
Times Of Grace	metalcore
Tom Morello	metalcore
Too Close To Touch	metalcore
Trapped Under Ice	metalcore
Trivium	metalcore
Turnstile	metalcore
Underoath	metalcore
We Love	metalcore
Whitechapel	metalcore
a crowd of rebellion	metalcore
coldrain	metalcore
dEMOTIONAL	metalcore
envy	metalcore
letlive.	metalcore
A Great Big Pile of Leaves	indie2
ANIMA!	indie2
Agar Agar	indie2
Alex Cameron	indie2
Allan Rayman	indie2
Alvvays	indie2
Amason	indie2
Amen Dunes	indie2
Anderson East	indie2
Angel Olsen	indie2
Angelo Badalamenti	indie2
Anna Burch	indie2
Anna Meredith	indie2
Apropos	indie2
Aqua Eyes	indie2
Archers Of Loaf	indie2
Ariel Pink	indie2
Athletics	indie2
BRONCHO	indie2
Bad Suns	indie2
Balkans	indie2
Beach Fossils	indie2
Beach House	indie2
Bedroom	indie2
Beirut	indie2
Belle & Sebastian	indie2
Benjamin Francis Leftwich	indie2
Best Coast	indie2
Beulah	indie2
Big Black	indie2
Bill Callahan	indie2
Björk	indie2
Blossoms	indie2
Bored Nothing	indie2
Broken Social Scene	indie2
Burial, Four Tet, Thom Yorke	indie2
Car Seat Headrest	indie2
Caroline Rose	indie2
Cayucas	indie2
Chelsea Wolfe	indie2
Christopher O'Riley	indie2
Chromatics	indie2
Circa Waves	indie2
Coast Modern	indie2
Cocteau Twins	indie2
Codeine	indie2
Cosmo Pyke	indie2
Courtney Barnett	indie2
Craft Spells	indie2
Crying	indie2
D.I.D	indie2
DIIV	indie2
DMA'S	indie2
Daan	indie2
Damien Jurado	indie2
Dan Croll	indie2
David Byrne	indie2
Day Wave	indie2
De Lux	indie2
Deap Vally	indie2
Dear and the Headlights	indie2
Declan McKenna	indie2
Deer Tick	indie2
Deerhunter	indie2
Dermot Kennedy	indie2
Diarrhea Planet	indie2
Dirty Projectors	indie2
Django Django	indie2
Don't Stop or We'll Die	indie2
Dream Wife	indie2
Drenge	indie2
E.B. Spencer	indie2
EL VY	indie2
Editors	indie2
Electric Guest	indie2
Elsiane	indie2
Emma Ruth Rundle	indie2
Everything Everything	indie2
FFS	indie2
Family Consumer Science	indie2
Father John Misty	indie2
Feng Suave	indie2
Findlay	indie2
First Aid Kit	indie2
Fleece	indie2
Foxygen	indie2
Frightened Rabbit	indie2
From Indian Lakes	indie2
Fruit Bats	indie2
Future Islands	indie2
Gang of Youths	indie2
Geographer	indie2
Gillian Welch	indie2
Good Kid	indie2
Guided By Voices	indie2
Gus Dapperton	indie2
Gypsy & The Cat	indie2
Have A Nice Life	indie2
Hippo Campus	indie2
Hockey Dad	indie2
Houndmouth	indie2
Interpol	indie2
J Mascis	indie2
Jake Bugg	indie2
Jamaican Queens	indie2
James Vincent McMorrow	indie2
Jamie T	indie2
Japandroids	indie2
Jens Lekman	indie2
Jim James	indie2
Johnny Jewel	indie2
Jonathan Wilson	indie2
Jonny Greenwood	indie2
Jordaan Mason & The Horse Museum	indie2
Joseph	indie2
Josh Homme	indie2
Jukebox The Ghost	indie2
Kay Kay and His Weathered Underground	indie2
Kiev	indie2
King Creosote	indie2
King Krule	indie2
Kishi Bashi	indie2
Kitten	indie2
Knox Hamilton	indie2
Kurt Vile	indie2
Lady Lamb	indie2
Last Dinosaurs	indie2
Lawrence	indie2
Liars	indie2
Little Comets	indie2
Lo Moon	indie2
Local Natives	indie2
Low	indie2
Lower Dens	indie2
Mac DeMarco	indie2
Madd	indie2
Magic City Hippies	indie2
Magic Wands	indie2
Majical Cloudz	indie2
Maps & Atlases	indie2
Mark Pritchard	indie2
Matt Corby	indie2
Mazzy Star	indie2
Mbongwana Star	indie2
Mcbaise	indie2
Melt	indie2
Melt-Banana	indie2
Mew	indie2
Michael Kiwanuka	indie2
Middle Kids	indie2
Miniature Tigers	indie2
Moon Taxi	indie2
Moses Gunn Collective	indie2
Moth Equals	indie2
Mount Eerie	indie2
Mountain Man	indie2
Mr Jukes	indie2
Mr Little Jeans	indie2
Neneh Cherry	indie2
Nick Curran and the Lowlifes	indie2
Noordpool Orchestra	indie2
Now, Now	indie2
O'Brother	indie2
Oberhofer	indie2
Olivier Libaux	indie2
On An On	indie2
Owen	indie2
PHOX	indie2
Paolo Meola	indie2
Pavement	indie2
Peach Pit	indie2
Philip Selway	indie2
Phoria	indie2
Pile	indie2
Polyenso	indie2
Postiljonen	indie2
Preston School Of Industry	indie2
Primal Scream	indie2
Private Island	indie2
Purple Disco Machine	indie2
RAT BOY	indie2
RY X	indie2
Rainbow Kitten Surprise	indie2
Rationale	indie2
Razorlight	indie2
Real Estate	indie2
Rentokill	indie2
Rex Orange County	indie2
Rhye	indie2
Robert Wyatt	indie2
Rockabye Baby!	indie2
Rubblebucket	indie2
SALES	indie2
SIR E.U	indie2
Said The Whale	indie2
Samsa	indie2
San Fermin	indie2
Sarah P.	indie2
School Of Seven Bells	indie2
Screaming Females	indie2
Seers	indie2
Serge Gainsbourg	indie2
Sharon Van Etten	indie2
Sheep, Dog & Wolf	indie2
Sjowgren	indie2
Skating Polly	indie2
Sleater-Kinney	indie2
Slint	indie2
Slow Corpse	indie2
Slowdive	indie2
Son Little	indie2
Songhoy Blues	indie2
Speedy Ortiz	indie2
Spirit Zoo	indie2
Spiritualized	indie2
Spoon	indie2
St. Lucia	indie2
Stereolab	indie2
Still Woozy	indie2
Sundara Karma	indie2
Sunset Rollercoaster	indie2
Sure Sure	indie2
Surfer Blood	indie2
Swans	indie2
Szymon	indie2
TENDER	indie2
TV Girl	indie2
Talk Talk	indie2
Tamino	indie2
Tanya Tagaq	indie2
Tennis	indie2
Thao & The Get Down Stay Down	indie2
The 6ths	indie2
The Arcs	indie2
The Beaches	indie2
The Breathing Effect	indie2
The Bright Light Social Hour	indie2
The Chills	indie2
The Derevolutions	indie2
The Dirty Nil	indie2
The Districts	indie2
The Drones	indie2
The Drums	indie2
The Extra Glenns	indie2
The Fiery Furnaces	indie2
The Floodshark	indie2
The Frights	indie2
The Go! Team	indie2
The Good, the Bad & the Queen	indie2
The Growlers	indie2
The Microphones	indie2
The New Pornographers	indie2
The Orwells	indie2
The Raincoats	indie2
The Rubens	indie2
The Rural Alberta Advantage	indie2
The Staves	indie2
The Sugarcanes	indie2
The Tallest Man On Earth	indie2
The Unicorns	indie2
The Vaccines	indie2
The Veils	indie2
The War On Drugs	indie2
The Wrens	indie2
The Zolas	indie2
Thom Yorke	indie2
Timber Timbre	indie2
Tino Rondz	indie2
Titus Andronicus	indie2
Travis Bretzer	indie2
Tune-Yards	indie2
Tunng	indie2
Typhoon	indie2
Unknown Mortal Orchestra	indie2
Villagers	indie2
Vinyl Theatre	indie2
Volcano Choir	indie2
Wavves	indie2
Wilco	indie2
Wild Beasts	indie2
Wilderness Survival	indie2
Will Butler	indie2
Will Hawkins	indie2
Wolf Alice	indie2
Xiu Xiu	indie2
Yo La Tengo	indie2
Youth Lagoon	indie2
Yuck	indie2
Zimtschneckchen	indie2
of Montreal	indie2
slenderbodies	indie2
together PANGEA	indie2
whatever the horror	indie2
A Night In Texas	deathcore
Acrania	deathcore
Angelmaker	deathcore
Auras	deathcore
Aversions Crown	deathcore
Carnifex	deathcore
Despised Icon	deathcore
Elitist	deathcore
Enterprise Earth	deathcore
Erra	deathcore
Fit For An Autopsy	deathcore
Humanity's Last Breath	deathcore
Jason Richardson	deathcore
Lorna Shore	deathcore
Monuments	deathcore
Oceano	deathcore
Rings of Saturn	deathcore
Shadow of Intent	deathcore
Shokran	deathcore
Slaughter to Prevail	deathcore
Slice The Cake	deathcore
The Acacia Strain	deathcore
Time, The Valuator	deathcore
Veil Of Maya	deathcore
Volumes	deathcore
Within The Ruins	deathcore
A R I Z O N A	pop
AJR	pop
AURORA	pop
Aaliyah	pop
Aaron Carter	pop
Adaline	pop
Afrika Bambaataa	pop
Alessia Cara	pop
Alex Agnew	pop
Alex Lahey	pop
Anaïs Mitchell	pop
Andrew McMahon in the Wilderness	pop
Annie	pop
Ariana Grande	pop
Arkells	pop
Ava Max	pop
Azealia Banks	pop
BANKS	pop
Ball Park Music	pop
Becky G	pop
Billie Eilish	pop
Bishop Briggs	pop
Bleachers	pop
Brandi Carlile	pop
Brian Wilson	pop
Broods	pop
BØRNS	pop
CHVRCHES	pop
COIN	pop
Calum Scott	pop
Cardi B	pop
Cast	pop
Catherine Feeny	pop
Chairlift	pop
Charlotte Martin	pop
Cher	pop
Christina Grimmie	pop
Christine and the Queens	pop
Ciara	pop
Clairo	pop
Coleman Hell	pop
Confidence Man	pop
Corinne Bailey Rae	pop
Cuco	pop
Cyn	pop
D12	pop
DZ Deathrays	pop
Dashboard Confessional	pop
Dean Lewis	pop
Dimitri De Alencar	pop
Dominique Cooper	pop
Enrique Iglesias	pop
Era Istrefi	pop
FKA twigs	pop
FRENSHIP	pop
Fat Tony	pop
Fazerdaze	pop
Felix Jaehn	pop
Fergie	pop
Fifth Harmony	pop
Fischerspooner	pop
Gallant	pop
Goldfrapp	pop
Grimes	pop
HAIM	pop
HONNE	pop
Hailee Steinfeld	pop
Halsey	pop
Harry Styles	pop
Hilary Duff	pop
Honeyblood	pop
Hurts	pop
I DONT KNOW HOW BUT THEY FOUND ME	pop
Ibeyi	pop
Iggy Azalea	pop
J Balvin	pop
Jack Garratt	pop
Jahn Rome	pop
James Arthur	pop
Janelle Monáe	pop
Janet Jackson	pop
Jennifer Lopez	pop
Jesse McCartney	pop
Jessie Reyez	pop
Jessie Ware	pop
Jewel	pop
John Grant	pop
John Legend	pop
Jon Bellion	pop
Justin Timberlake	pop
K.Flay	pop
KEY!	pop
KT Tunstall	pop
Kacey Musgraves	pop
Kat Dahlia	pop
Katy B	pop
Kelly Clarkson	pop
Kelly Rowland	pop
Kero Kero Bonito	pop
Kesha	pop
Kiiara	pop
Knox Fortune	pop
Kylie Minogue	pop
Ladyhawke	pop
Lake Street Dive	pop
Lights	pop
Little Big Town	pop
Lizzo	pop
Lorde	pop
Lukas Graham	pop
Lykke Li	pop
MAX	pop
Mae	pop
Maluma	pop
Marian Hill	pop
Mary J. Blige	pop
Matt Maeson	pop
Matt and Kim	pop
Michael Bublé	pop
Mike Shinoda	pop
Missy Higgins	pop
MisterWives	pop
Mitski	pop
Morrissey	pop
Mt. Joy	pop
MØ	pop
Natalia Kills	pop
Natalia Lafourcade	pop
Ne-Yo	pop
Neko Case	pop
Nelly Furtado	pop
Nerina Pallot	pop
Nico & Vinz	pop
Nothing But Thieves	pop
Ocean Alley	pop
Oh Wonder	pop
PHILDEL	pop
Perfume Genius	pop
Pixx	pop
Priest	pop
Quinn XCII	pop
R. Kelly	pop
ROSALÍA	pop
Rae Morris	pop
Rigid Moods	pop
Rob Lynch	pop
Robyn	pop
Rose Elinor Dougall	pop
Roy Blair	pop
Ruth B.	pop
Ryn Weaver	pop
Say Lou Lou	pop
Seinabo Sey	pop
Shamir	pop
Shura	pop
Sir Michael Rocks	pop
Sky Ferreira	pop
Skylar Grey	pop
Sneaky Sound System	pop
Sofi Tukker	pop
Solange	pop
Soul Asylum	pop
St. Vincent	pop
Superfly	pop
Susanne Sundfør	pop
Taylor Swift	pop
Tei Shi	pop
Tessa Violet	pop
The 1975	pop
The Clientele	pop
The Jacksons	pop
The Japanese House	pop
The Knocks	pop
The Marías	pop
The Regrettes	pop
The Ronettes	pop
The Sound of Arrows	pop
Usher	pop
Vallis Alps	pop
Varsity	pop
Vera Blue	pop
Wallows	pop
Welshly Arms	pop
Wet	pop
YUNGBLUD	pop
Yaeji	pop
Years & Years	pop
Youngr	pop
Zella Day	pop
ayokay	pop
blackbear	pop
dodie	pop
little xs for eyes	pop
lovelytheband	pop
A-F-R-O	edm2
Afterparty	edm2
Alesso	edm2
Alexander Lewis	edm2
Alison Wonderland	edm2
Alok	edm2
Alon Mor	edm2
AlunaGeorge	edm2
Anna Lunoe	edm2
Autograf	edm2
Baauer	edm2
Barclay Crenshaw	edm2
Bassjackers	edm2
Bassnectar	edm2
Benny Benassi	edm2
Big Wild	edm2
Blackmill	edm2
Bob Moses	edm2
Borgore	edm2
Boys Noize	edm2
Broken Note	edm2
CAZZETTE	edm2
CamelPhat	edm2
Cash Cash	edm2
Cashmere Cat	edm2
Chase & Status	edm2
Cheat Codes	edm2
Culprate	edm2
DJ Fresh	edm2
DJ Snake	edm2
Danger	edm2
Darude	edm2
David Guetta	edm2
Dillon Francis	edm2
Dimitri Vegas & Like Mike	edm2
Diplo	edm2
Downlink	edm2
Eekkoo	edm2
Electric Mantis	edm2
Elliphant	edm2
Eprom	edm2
Eric Prydz	edm2
Fakear	edm2
Feed Me	edm2
Flume	edm2
Flux Pavilion	edm2
Foreign Beggars	edm2
GRiZ	edm2
Galimatias	edm2
Ganja White Night	edm2
Gemini	edm2
Getter	edm2
Girl Unit	edm2
Goldroom	edm2
Gorgon City	edm2
Grey	edm2
Grum	edm2
Hayden James	edm2
Hippie Sabotage	edm2
Horsepower Productions	edm2
Hudson Mohawke	edm2
I Am Legion	edm2
Ivan Gough	edm2
Jai Paul	edm2
Jai Wolf	edm2
Jason Miller	edm2
Jonas Blue	edm2
KOAN Sound	edm2
Kaskade	edm2
Keys N Krates	edm2
Klaypex	edm2
Krewella	edm2
Kungs	edm2
Kygo	edm2
Lifelike	edm2
Liquid Stranger	edm2
Loud Luxury	edm2
Louis The Child	edm2
Lunice	edm2
Lxmberjack	edm2
Marshmello	edm2
Mat Zo	edm2
Matoma	edm2
Mija	edm2
Mike Perry	edm2
Mr. Carmack	edm2
Mt. Eden	edm2
Mura Masa	edm2
NERO	edm2
ODESZA	edm2
Oliver	edm2
Oliver Heldens	edm2
Opiuo	edm2
PANTyRAiD	edm2
Petit Biscuit	edm2
Phaeleh	edm2
Pham	edm2
Phutureprimitive	edm2
Rezz	edm2
Rone	edm2
Rusko	edm2
RÜFÜS DU SOL	edm2
SG Lewis	edm2
Sam Feldt	edm2
Sam Gellaitry	edm2
Sander van Doorn	edm2
Sean Paul	edm2
SebastiAn	edm2
Sebastian Ingrosso	edm2
Seeb	edm2
Sepharina	edm2
Sigala	edm2
Silk City	edm2
Simon Patterson	edm2
Skream	edm2
Slow Magic	edm2
Snakehips	edm2
Sparkee	edm2
Steve Aoki	edm2
TandMProductionCo	edm2
Tennyson	edm2
The Bloody Beetroots	edm2
The Chainsmokers	edm2
The M Machine	edm2
The Opposites	edm2
The Orb	edm2
Tim Berg	edm2
Tiësto	edm2
Totally Enormous Extinct Dinosaurs	edm2
Tourist	edm2
Unicorn Kid	edm2
Veorra	edm2
Vexare	edm2
Virtual Self	edm2
Wave Racer	edm2
What So Not	edm2
Whethan	edm2
Wilkinson	edm2
WolF6looD	edm2
Worakls	edm2
Yellow Claw	edm2
ZHU	edm2
Zeds Dead	edm2
Zomby	edm2
araabMUZIK	edm2
deadmau5	edm2
kache	edm2
she	edm2
A. G. Cook	underground hip hop
Adamn Killa	underground hip hop
BONES	underground hip hop
Bladee	underground hip hop
Bones	underground hip hop
Ecco2k	underground hip hop
Lil Tracy	underground hip hop
Thaiboy Digital	underground hip hop
Wicca Phase Springs Eternal	underground hip hop
Xavier Wulf	underground hip hop
jonatan leandoer96	underground hip hop
AJ Tracey	grime
Avelino	grime
Bugzy Malone	grime
CASISDEAD	grime
Chip	grime
D Double E	grime
Devlin	grime
Jaykae	grime
Krept & Konan	grime
Lethal Bizzle	grime
Manga Saint Hilare	grime
Novelist	grime
P Money	grime
President T	grime
Ruff Sqwad	grime
Sir Spyro	grime
Wiley	grime
slowthai	grime
ALMA	pop3
Allie X	pop3
Betty Who	pop3
Bridgit Mendler	pop3
Chelsea Cutler	pop3
Dagny	pop3
Elohim	pop3
Fickle Friends	pop3
GIRLI	pop3
HANA	pop3
HOLYCHILD	pop3
JoJo	pop3
Julia Michaels	pop3
Kate Nash	pop3
Kim Petras	pop3
Lea Michele	pop3
Liam Payne	pop3
Louis Tomlinson	pop3
Luna Shadows	pop3
LÉON	pop3
MNEK	pop3
MUNA	pop3
Maty Noyes	pop3
Niall Horan	pop3
Nina Nesbitt	pop3
Olivia O'Brien	pop3
PRETTYMUCH	pop3
Pale Waves	pop3
Qveen Herby	pop3
Rina Sawayama	pop3
Sabrina Carpenter	pop3
Sabrina Claudio	pop3
Superfruit	pop3
Thomston	pop3
Timeflies	pop3
Tinashe	pop3
VÉRITÉ	pop3
flor	pop3
ANDY SVGE	hardstyle
Angerfist	hardstyle
Atmozfears	hardstyle
Audiofreq	hardstyle
Audiotricz	hardstyle
Bass Modulators	hardstyle
Brennan Heart	hardstyle
Clockartz	hardstyle
Code Black	hardstyle
Coone	hardstyle
Crypsis	hardstyle
D-Block & S-te-Fan	hardstyle
D-Sturb	hardstyle
Da Tweekaz	hardstyle
Darren Styles	hardstyle
Devin Wild	hardstyle
Dj Thera	hardstyle
Donkey Rollers	hardstyle
E-Force	hardstyle
Evil Activities	hardstyle
Frequencerz	hardstyle
Frontliner	hardstyle
Gunz For Hire	hardstyle
Hard Driver	hardstyle
Headhunterz	hardstyle
Jebroer	hardstyle
MYST	hardstyle
Noisecontrollers	hardstyle
Ophidian	hardstyle
Phuture Noize	hardstyle
Project One	hardstyle
Psyko Punkz	hardstyle
Radical Redemption	hardstyle
Ran-D	hardstyle
Sefa	hardstyle
Showtek	hardstyle
Sub Zero Project	hardstyle
Warface	hardstyle
Wasted Penguinz	hardstyle
Wildstylez	hardstyle
Zatox	hardstyle
AS IT IS	poppunk2
Armor For Sleep	poppunk2
Balance And Composure	poppunk2
Belmont	poppunk2
Boston Manor	poppunk2
Boys Night Out	poppunk2
Citizen	poppunk2
Columbus	poppunk2
Elder Brother	poppunk2
Finch	poppunk2
Fireworks	poppunk2
Four Year Strong	poppunk2
Graduating Life	poppunk2
Grandview	poppunk2
Grayscale	poppunk2
Have Mercy	poppunk2
In Her Own Words	poppunk2
Knuckle Puck	poppunk2
Like Pacific	poppunk2
Mayday Parade	poppunk2
Microwave	poppunk2
Moose Blood	poppunk2
Movements	poppunk2
Neck Deep	poppunk2
New Found Glory	poppunk2
ROAM	poppunk2
Rarity	poppunk2
Real Friends	poppunk2
Seaway	poppunk2
Sparrow Sleeps	poppunk2
Stand Atlantic	poppunk2
State Champs	poppunk2
Sylvania Ave.	poppunk2
The Starting Line	poppunk2
The Story So Far	poppunk2
The Wonder Years	poppunk2
Tigers Jaw	poppunk2
Trash Boat	poppunk2
Trophy Eyes	poppunk2
WSTR	poppunk2
Waterparks	poppunk2
With Confidence	poppunk2
zebrahead	poppunk2
ATB	trance
Above & Beyond	trance
Andrew Bayer	trance
Armin van Buuren	trance
Astrix	trance
BT	trance
Ben Archbold	trance
Breakfast	trance
Chicane	trance
Cirez D	trance
Claude VonStroke	trance
DJ Zinc	trance
Dennis De Laat	trance
Dusky	trance
Ferry Corsten presents Gouryella	trance
GAIA	trance
Gabriel & Dresden	trance
Gareth Emery	trance
Gouryella	trance
Hilight Tribe	trance
Hybrid	trance
Lane 8	trance
Matt Lange	trance
Michael Cassette	trance
Moguai	trance
Moon Boots	trance
Mord Fustang	trance
Motorcycle	trance
No Mana	trance
Oliver Smith	trance
Omnia	trance
Orjan Nilsen	trance
Paul van Dyk	trance
Pryda	trance
Push	trance
Rank 1	trance
Sasha	trance
Solarstone	trance
Spencer Brown	trance
Sunny Lax	trance
Yotto	trance
AZIATIX	Japanese
BABYMETAL	Japanese
BAND-MAID	Japanese
Cornelius	Japanese
DAOKO	Japanese
Do As Infinity	Japanese
GARNiDELiA	Japanese
Gesu No Kiwami Otome	Japanese
Haru Nemuri	Japanese
Ichiko Aoba	Japanese
Indigo la End	Japanese
KANA-BOON	Japanese
Kenichiro Nishihara	Japanese
Kinokoteikoku	Japanese
Lamp	Japanese
Lucie,Too	Japanese
MASS OF THE FERMENTING DREGS	Japanese
Mondo Grosso	Japanese
OGRE YOU ASSHOLE	Japanese
POLKADOT STINGRAY	Japanese
Perfume	Japanese
Reol	Japanese
SHISHAMO	Japanese
Sakanaction	Japanese
Sheena Ringo	Japanese
Suchmos	Japanese
TeddyLoid	Japanese
WEDNESDAY CAMPANELLA	Japanese
WagakkiBand	Japanese
fox capture plan	Japanese
m-flo	Japanese
tricot	Japanese
Aaron Johnston, Jesse Murphy & Avi Bortnick	video game music
Ashley Johnson	video game music
Ashtar Command	video game music
Austin Wintory	video game music
Baiyon	video game music
Ben Prunty	video game music
Bill Elm & Woody Jackson	video game music
Brad Derrick	video game music
Braxton Burks	video game music
Capcom Sound Team	video game music
Captainsparklez	video game music
Chris Christodoulou	video game music
Chris Huelsbeck	video game music
Christopher Larkin	video game music
ConcernedApe	video game music
Cranius	video game music
Crush 40	video game music
DJ Envy	video game music
Dagames	video game music
Dan Romer	video game music
Daniel Tidwell	video game music
Danny Baranowsky	video game music
Darren Korb	video game music
Ed Harrison	video game music
Emmanuel Fratianni	video game music
Eric Buchholz	video game music
Faunts	video game music
Frank Klepacki	video game music
GENTLE LOVE	video game music
Gareth Coker	video game music
Garoad	video game music
Garry Schyman	video game music
Glenn Stafford	video game music
Glenn Yarbrough & The Limeliters	video game music
Graeme Norgate	video game music
Gustavo Santaolalla	video game music
Hideki Naganuma	video game music
Hollywood Principle	video game music
Hyper	video game music
ICO	video game music
Inon Zur	video game music
Jack Wall	video game music
Jake Kaufman	video game music
Jamie Lidell	video game music
Jason Hayes	video game music
Jeremy Soule	video game music
Jerry Martin	video game music
Jesper Kyd	video game music
Jim Guthrie	video game music
Johan Skugge	video game music
Johan Söderqvist	video game music
Joris de Man	video game music
Justin Bell	video game music
Kazuma Jinnouchi	video game music
Kristofer Maddigan	video game music
Lena Raine	video game music
Lifeformed	video game music
Lisa Miskovsky	video game music
Machinae Supremacy	video game music
Maclaine Diemer	video game music
Magnus Deus	video game music
Marcin Przybyłowicz	video game music
Martin O'Donnell	video game music
Mcap Steve	video game music
Michael McCann	video game music
Michael Salvatori	video game music
Michiru Yamane	video game music
Mick Gordon	video game music
Midnight Syndicate	video game music
Mike Ault	video game music
Mike Ness	video game music
Mikel	video game music
Moka	video game music
Motoi Sakuraba	video game music
Neal Acree	video game music
Nobuo Uematsu	video game music
Pascal Michael Stiefel	video game music
Pawel Blaszczak	video game music
Peter Hollens	video game music
Peter McConnell	video game music
Petri Alanko	video game music
Piotr Musiał	video game music
R47	video game music
Ridiculon	video game music
Robin Beanland	video game music
SEGA SOUND TEAM	video game music
SIE Sound Team	video game music
Sarah Schachner	video game music
Sean Dagher	video game music
Shawn James	video game music
Shinyribs	video game music
Simon Viklund	video game music
Starbomb	video game music
Starsailor	video game music
Stefanie Joosten	video game music
Stuart Chatwood	video game music
The Adventures of Duane & Brando	video game music
The Black Piper	video game music
The Dreadnoughts	video game music
The Megas	video game music
Thomas Happ	video game music
Tina Guo	video game music
Toby Fox	video game music
Tomáš Dvořák	video game music
Trevor Morris	video game music
Valve Studio Orchestra	video game music
Video Games Live	video game music
William Elliott Whitmore	video game music
William Joseph & Lindsey Stirling	video game music
Above, Below	metalcore2
Adept	metalcore2
After The Burial	metalcore2
Air I Breathe, The	metalcore2
Alazka	metalcore2
Alpha Wolf	metalcore2
Any Given Day	metalcore2
Atena	metalcore2
Aviana	metalcore2
Bad Omens	metalcore2
Bleed From Within	metalcore2
Born Of Osiris	metalcore2
Breakdown of Sanity	metalcore2
Buried In Verona	metalcore2
Bury Tomorrow	metalcore2
Casey	metalcore2
Chelsea Grin	metalcore2
Conquer Divide	metalcore2
Counterparts	metalcore2
Crystal Lake	metalcore2
Currents	metalcore2
Defeater	metalcore2
Diamond Construct	metalcore2
END	metalcore2
ERRA	metalcore2
Employed To Serve	metalcore2
Famous Last Words	metalcore2
Fit For A King	metalcore2
For The Fallen Dreams	metalcore2
Forevermore	metalcore2
Forgetting The Memories	metalcore2
Gideon	metalcore2
Heart Of A Coward	metalcore2
Hollow Front	metalcore2
I The Breather	metalcore2
In Hearts Wake	metalcore2
Invent, Animate	metalcore2
It Dies Today	metalcore2
It Prevails	metalcore2
Kingdom Of Giants	metalcore2
Kublai Khan TX	metalcore2
LANDMVRKS	metalcore2
Landon Tewers	metalcore2
Like Moths To Flames	metalcore2
Loathe	metalcore2
Make Them Suffer	metalcore2
Memphis May Fire	metalcore2
Miss May I	metalcore2
Motionless In White	metalcore2
Napoleon	metalcore2
Norma Jean	metalcore2
Northlane	metalcore2
Novelists	metalcore2
Ocean Grove	metalcore2
Oceans Ate Alaska	metalcore2
Oh, Sleeper	metalcore2
Our Hollow, Our Home	metalcore2
Phinehas	metalcore2
Polaris	metalcore2
RITUAL	metalcore2
Reflections	metalcore2
Secrets	metalcore2
Shapist	metalcore2
Shrezzers	metalcore2
Silent Planet	metalcore2
Sirens And Sailors	metalcore2
Stick To Your Guns	metalcore2
Stories	metalcore2
The Afterimage	metalcore2
The Crimson Armada	metalcore2
The Dali Thundering Concept	metalcore2
The Devil Wears Prada	metalcore2
The Gloom In The Corner	metalcore2
The New Age	metalcore2
The Plot In You	metalcore2
The Word Alive	metalcore2
Thornhill	metalcore2
Thousand Below	metalcore2
Vaela	metalcore2
Vanna	metalcore2
Varials	metalcore2
Vein	metalcore2
Wage War	metalcore2
We Came As Romans	metalcore2
While She Sleeps	metalcore2
Wolves At The Gate	metalcore2
blessthefall	metalcore2
Adore Delano	strut
Aja	strut
Alaska Thunderfuck	strut
Bob the Drag Queen	strut
Courtney Act	strut
Dorian Electra	strut
Jinkx Monsoon	strut
Lucian Piane	strut
Miss Fame	strut
RuPaul	strut
Shea Couleé	strut
Trixie Mattel	strut
Violet Chachki	strut
Willam	strut
Adventures	emo
Algernon Cadwallader	emo
All Get Out	emo
Basement	emo
Bay Faction	emo
Beach Bunny	emo
Braid	emo
CSTVT	emo
Camp Cope	emo
Dikembe	emo
Free Throw	emo
Girlfriends	emo
I Feel Fine	emo
Iron Chic	emo
It Looks Sad.	emo
Joyce Manor	emo
McCafferty	emo
Midnight Foolishness	emo
Mineral	emo
Mom Jeans.	emo
Pianos Become The Teeth	emo
Prince Daddy & the Hyena	emo
Remo Drive	emo
Saves The Day	emo
Sincere Engineer	emo
Slaughter Beach, Dog	emo
Sorority Noise	emo
The Hotelier	emo
Tiny Moving Parts	emo
Tongues of Fire	emo
Touché Amoré	emo
Traveler	emo
Will Monahan	emo
You Blew It!	emo
Aero Chord	monstercat
Anevo	monstercat
Au5	monstercat
Azedia	monstercat
Braken	monstercat
Case & Point	monstercat
Chime	monstercat
Conro	monstercat
Crywolf	monstercat
Deon Custom	monstercat
Direct	monstercat
Dirty Audio	monstercat
Disfigure	monstercat
Dodge & Fuski	monstercat
DotEXE	monstercat
Draper	monstercat
Droptek	monstercat
Dubloadz	monstercat
EDEN	monstercat
Electus	monstercat
Ephixa	monstercat
F.O.O.L	monstercat
Feint	monstercat
Fox Stevenson	monstercat
Grabbitz	monstercat
Haywyre	monstercat
Hellberg	monstercat
Hyper Potions	monstercat
Jeremy Zucker	monstercat
KUURO	monstercat
Karma Fields	monstercat
Koven	monstercat
LVTHER	monstercat
La Caution	monstercat
Laszlo	monstercat
Lets Be Friends	monstercat
MDK	monstercat
MUZZ	monstercat
Melano	monstercat
Monstercat	monstercat
Mr FijiWiji	monstercat
Nigel Good	monstercat
Nitro Fun	monstercat
PYLOT	monstercat
Panda Eyes	monstercat
Pegboard Nerds	monstercat
Pixl	monstercat
Project 46	monstercat
Protostar	monstercat
Puppet	monstercat
Rameses B	monstercat
Razihel	monstercat
Rezonate	monstercat
Rogue	monstercat
Rootkit	monstercat
SCNDL	monstercat
SMLE	monstercat
Savant	monstercat
Savoy	monstercat
Slippy	monstercat
Snavs	monstercat
Stephen	monstercat
Stephen Walking	monstercat
Stonebank	monstercat
Subtact	monstercat
Summer Was Fun	monstercat
TAI	monstercat
TVDS	monstercat
Televisor	monstercat
Teminite	monstercat
TheFatRat	monstercat
Tobu	monstercat
Tokyo Machine	monstercat
Topi	monstercat
Tristam	monstercat
Trivecta	monstercat
Tut Tut Child	monstercat
Unlike Pluto	monstercat
Varien	monstercat
WRLD	monstercat
Zes	monstercat
dark cat	monstercat
nanobii	monstercat
Aeryk Bacon	spotify
Allan Thomas	spotify
Always Bloom	spotify
Anastasia Rizing	spotify
Annalisa	spotify
Barbara Borgelin	spotify
Brandon Kai	spotify
Hunned Kay	spotify
Iván Geraldo	spotify
J.M.K.E.	spotify
Jon Magnusson	spotify
Joric	spotify
Klamydia	spotify
Leg Puppy	spotify
Los Brownnies	spotify
MC Rich	spotify
Mind Over Matter	spotify
Picnics at his Adamah!	spotify
RageMD	spotify
Shawn Sleeps Naked	spotify
Stam1na	spotify
Suburban Dream	spotify
Taylor J	spotify
Taylored	spotify
The Wolf Rock Band	spotify
Turmion Kätilöt	spotify
Ursa the Chef	spotify
Wvs	spotify
dom champ	spotify
petal boy	spotify
Aimer	otacore
AmaLee	otacore
BRADIO	otacore
Blake	otacore
Bruce Faulconer	otacore
Casey Edwards	otacore
ClariS	otacore
Coda	otacore
Crusher-P	otacore
Daniel Ingram	otacore
EDO BOYS	otacore
EGOIST	otacore
Erasure	otacore
FLOW	otacore
Falcom Sound Team jdk	otacore
Fluorescents	otacore
Giles Lamb	otacore
Hiroaki Tommy Tominaga	otacore
Hiroyuki Sawano	otacore
Ho - Kago Tea Time	otacore
J25K	otacore
JAMES SHIMOJI	otacore
Kalafina	otacore
Kana Hanazawa	otacore
Ken Ashcorp	otacore
Kensuke Ushio	otacore
Kevin Penkin	otacore
Kitashirakawa Tamako (CV: Aya Suzuki)	otacore
Linked Horizon	otacore
Little V.	otacore
MAN WITH A MISSION	otacore
MYTH & ROID	otacore
Masafumi Takada	otacore
Masakatsu Takagi	otacore
Mili	otacore
Momoiro Clover Z	otacore
NakamuraEmi	otacore
Nana Mizuki	otacore
OxT	otacore
Project Destati	otacore
RADWIMPS	otacore
Raito	otacore
Red Vox	otacore
RiffShop	otacore
STUDIO TRAM	otacore
Scribes	otacore
Shiro Sagisu	otacore
Shoko Nakagawa	otacore
Static-P	otacore
TK from Ling tosite sigure	otacore
Weekend Players	otacore
Yasuharu Takanashi	otacore
Yugo Kanno	otacore
batta	otacore
fhána	otacore
mabanua	otacore
supercell	otacore
the pillows	otacore
物語シリーズ	otacore
Alan Lomax	jazz
Alice Coltrane	jazz
Arne Domnérus	jazz
Art Blakey	jazz
Art Blakey & The Jazz Messengers	jazz
Avishai Cohen	jazz
Baby Huey & The Baby Sitters	jazz
Betty Davis	jazz
Bill Evans	jazz
Bootsy Collins	jazz
Brad Mehldau	jazz
Buddy Guy	jazz
Cannonball Adderley	jazz
Charles Mingus	jazz
Charlie Parker	jazz
Chet Baker	jazz
Chick Corea	jazz
Christian Scott aTunde Adjuah	jazz
Clifford Brown	jazz
Cory Wong	jazz
Dizzy Gillespie	jazz
Donald Byrd	jazz
Dr. Lonnie Smith	jazz
Duke Ellington	jazz
Eli Degibri	jazz
Eric Dolphy	jazz
Esperanza Spalding	jazz
Fats Waller	jazz
Fire! Orchestra	jazz
Freddie Hubbard	jazz
Funkadelic	jazz
G. Love & Special Sauce	jazz
GoGo Penguin	jazz
Grateful Dead	jazz
Herbie Hancock	jazz
Hidden Orchestra	jazz
Hiromi	jazz
Horace Silver	jazz
Howlin' Wolf	jazz
Jacob Collier	jazz
Jaga Jazzist	jazz
Jerry Garcia	jazz
Jerry Garcia Band	jazz
John Coltrane	jazz
John Coltrane Quartet	jazz
Julian Lage	jazz
Kamasi Washington	jazz
Lettuce	jazz
Lonnie Liston Smith and the Cosmic Echoes	jazz
Matthew Perryman Jones	jazz
Medeski, Martin & Wood	jazz
Menahan Street Band	jazz
Miles Davis	jazz
Mingus Big Band	jazz
Moonchild	jazz
Mulatu Astatke	jazz
Oscar Peterson Trio	jazz
Pat Metheny Group	jazz
Portico Quartet	jazz
R.L. Burnside	jazz
Shuggie Otis	jazz
Snarky Puppy	jazz
"Soil & ""Pimp"" Sessions"	jazz
Sonny Rollins	jazz
Sons Of Kemet	jazz
Soulive	jazz
Spafford	jazz
Steve Reich	jazz
Sun Ra	jazz
Takuya Kuroda	jazz
The Bad Plus	jazz
The Brand New Heavies	jazz
The Budos Band	jazz
The Dave Brubeck Quartet	jazz
The Fearless Flyers	jazz
Thelonious Monk	jazz
Theo Katzman	jazz
Tower Of Power	jazz
Vince Guaraldi Trio	jazz
Vulfpeck	jazz
Wayne Shorter	jazz
Wes Montgomery	jazz
Yussef Kamaal	jazz
Zapp	jazz
aaspeaker.com	jazz
Alan Silvestri	soundtrack
Alexandre Desplat	soundtrack
Andrez Romero	soundtrack
Audiomachine	soundtrack
Auralnauts	soundtrack
Bear McCreary	soundtrack
Bedlam Bards	soundtrack
Ben Salisbury	soundtrack
Benjamin Wallfisch	soundtrack
Blake Neely	soundtrack
Brian Reitzell	soundtrack
Cassius Clay	soundtrack
Chameleon Circuit	soundtrack
Chris Joss	soundtrack
Chris Lilley	soundtrack
Cliff Martinez	soundtrack
Clint Mansell	soundtrack
Creed Bratton	soundtrack
Cristobal Tapia De Veer	soundtrack
Daniel Licht	soundtrack
Daniel Pemberton	soundtrack
Danny Elfman	soundtrack
Dave Porter	soundtrack
Doctor Who	soundtrack
Dragons	soundtrack
Henry Jackman	soundtrack
Irma Thomas	soundtrack
James	soundtrack
Jeff Beal	soundtrack
Jeff Russo	soundtrack
John Paesano	soundtrack
John Williams	soundtrack
Joshua Morse	soundtrack
Justin Hurwitz	soundtrack
Jóhann Jóhannsson	soundtrack
Keala Settle	soundtrack
Kevin Kiner	soundtrack
Kyle Dixon & Michael Stein	soundtrack
Lennie Moore	soundtrack
Lera Lynn	soundtrack
Leroy	soundtrack
Ludwig Goransson	soundtrack
MTO	soundtrack
Mac Quayle	soundtrack
Madreblu	soundtrack
Marco Beltrami	soundtrack
Mark Mothersbaugh	soundtrack
Max Richter	soundtrack
Michael Giacchino	soundtrack
Mick Harvey	soundtrack
Mint Royale	soundtrack
Parsonsfield	soundtrack
Patrick Carney	soundtrack
Raleigh Ritchie	soundtrack
Ramin Djawadi	soundtrack
Rupert Gregson-Williams	soundtrack
Samuel Barber	soundtrack
Shigeru Umebayashi	soundtrack
Sing Street	soundtrack
Sion	soundtrack
The 88	soundtrack
The Bombay Royale	soundtrack
The Evil Exes	soundtrack
The Hat	soundtrack
The National	soundtrack
The Sneepers	soundtrack
Thomas Newman	soundtrack
Tyler Bates	soundtrack
Tyler Ward	soundtrack
Wang Chung	soundtrack
Weebl's Stuff	soundtrack
Alix Perez	DnB
Amphix	DnB
Andy C	DnB
Apex	DnB
Bad Company UK	DnB
Black Sun Empire	DnB
Boxplot	DnB
Calibre	DnB
Calyx	DnB
Calyx & TeeBee	DnB
Camo & Krooked	DnB
Commix	DnB
Culture Shock	DnB
Current Value	DnB
Cyantific	DnB
DC Breaks	DnB
DRS	DnB
Danny Byrd	DnB
Dawn Wall	DnB
Dimension	DnB
Etherwood	DnB
Flite	DnB
Fred V & Grafix	DnB
Friction	DnB
Goldie	DnB
High Contrast	DnB
Hugh Hardie	DnB
Hybrid Minds	DnB
Joe Ford	DnB
Keeno	DnB
Konflict	DnB
Linear	DnB
Logistics	DnB
London Elektricity	DnB
MRSA	DnB
Maduk	DnB
Matrix & Futurebound	DnB
Mefjus	DnB
Metrik	DnB
Mistabishi	DnB
Netsky	DnB
Noisia	DnB
Nu:Logic	DnB
Origin Unknown	DnB
Reso	DnB
S.P.Y	DnB
SpectraSoul	DnB
Spor	DnB
Sub Focus	DnB
Technimatic	DnB
The Qemists	DnB
The Upbeats	DnB
dBridge	DnB
Ang Bandang Shirley	Philippines
Ben&Ben	Philippines
Eraserheads	Philippines
Quest	Philippines
Up Dharma Down	Philippines
Brothers of Metal	power metal
Civil War	power metal
Delain	power metal
Dream Evil	power metal
Epica	power metal
Equilibrium	power metal
Ex Deo	power metal
Falconer	power metal
Freedom Call	power metal
Grailknights	power metal
Grave Digger	power metal
Helion Prime	power metal
Hulkoff	power metal
Iced Earth	power metal
Kamelot	power metal
Manilla Road	power metal
Orden Ogan	power metal
Scanner	power metal
Seventh Wonder	power metal
Sirenia	power metal
Stratovarius	power metal
Triosphere	power metal
Twilight Force	power metal
Unlucky Morpheus	power metal
Whispered	power metal
Cezhu	LoFi
Chade Summerset	LoFi
CoolCalmMaurice	LoFi
Craig J.	LoFi
Doi Havto	LoFi
Electricsheep42	LoFi
J. Boom	LoFi
Keevin	LoFi
Larry Choppins	LoFi
Lil Ray Ray	LoFi
Liouville	LoFi
Maalwe.	LoFi
Manny Keep	LoFi
Mark Rybczynski	LoFi
Miles Kang	LoFi
Mirrorish	LoFi
Nom Tunes	LoFi
Norado	LoFi
Oh, My.	LoFi
Pao	LoFi
Postmark	LoFi
The MaddGeek	LoFi
Tony Paone	LoFi
Vin¢	LoFi
Edward Mewburn	my music
Hipster Pug	my music
Nick Warner	my music
No Alarms	my music
Otter Falls	my music
