artist	genre
"""Da"" Y"	internet culture
"""Weird Al"" Yankovic"	internet culture
#1 Funny Ringtones for Android Best New Annoying Comedy Parody Alerts Alarms Message Tones Tone Alert & Messages	internet culture
$Ha Hef	synthwave
$teven Cannon	politically engaged
$uicideBoy$	rap 3
'68	pop-punk 1
(G)I-DLE	K-pop 1
(Sandy) Alex G	indie 3
*NSYNC	internet culture 2
009 Sound System	internet culture
03 Greedo	rap 3
070 Shake	rap 3
10 Years	indie 1
100%	K-pop 2
1000mods	alternative metal
10cc	rock
11 Years of This	music makers 1
12th Planet	edm 2
12xAM	rock
1788-L	edm 2
1991	electronica
199X	despacito
2 Chainz	rap 3
20syl	indietronica
21 Savage	rap 3
22	progressive metal
257ers	Europe
2CELLOS	rock
2NE1	K-pop 1
2PM	K-pop 2
2Pac	rap 2
2WEI	internet culture
2play4you	music makers 1
3 Doors Down	internet culture
311	indietronica
3LAU	edm 2
3TEETH	synthwave
4 Non Blondes	rock
40 Watt Sun	doom metal
45 Grave	pop-punk 1
4hero	indietronica
4th Lyric	internet culture
5 Seconds of Summer	pop 2
50 Cent	rap 1
6 Dogs	rap 3
65daysofstatic	indietronica
6LACK	rap 3
6ix9ine	rap 1
727's	psychedelic rock
7DD9	music makers 1
8 Bit Universe	indie 1
8-Bit Arcade	internet culture
8-Off Agallah Featuring Sean Price & Bazaar Royale	rap 1
88GLAM	rap 3
88rising	rap 1
99 Souls	indietronica
9MUSES	K-pop 2
:Wumpscut:	internet culture
A Boogie Wit da Hoodie	rap 3
A Day To Remember	metalcore 1
A Fine Frenzy	indie 1
A Flock Of Seagulls	internet culture 2
A Great Big Pile of Leaves	indie 2
A Great Big World	internet culture 2
A Lot Like Birds	metalcore 1
A Night In Texas	progressive metal 2
A Perfect Circle	rock
A Presença das Formigas	psychedelic rock
A R I Z O N A	pop 1
A Skylit Drive	metalcore 1
A Sunny Day In Glasgow	indie 3
A Tribe Called Quest	rap 1
A Tribe Called Red	rap 2
A Winged Victory for the Sullen	psychedelic rock
A$AP Ferg	rap 3
A$AP Mob	rap 1
A$AP Rocky	rap 1
A$AP Twelvyy	rap 3
A-F-R-O	edm 1
A-Trak	rap 3
A. G. Cook	rap 4
A.C.E	K-pop 2
A.CHAL	rap 3
ABBA	internet culture 2
ABRA	pop 2
AC Slater	edm 2
AFI	rock
AJ Tracey	grime
AJJ	indie 1
AJR	pop 1
AKMU	K-pop 1
ALMA	pop 3
ALPHA 9	edm 2
AMBER	K-pop 2
ANDY SVGE	hardstyle
ANIMA!	indie 2
ANOHNI	indie 3
AOA	K-pop 1
AREA21	edm 2
ARTY	edm 2
AS IT IS	pop-punk 2
ASIAN KUNG-FU GENERATION	internet culture 2
ASTRO	K-pop 2
ATB	trance
ATEEZ	K-pop 2
ATTLAS	edm 2
AURORA	pop 1
AWOLNATION	internet culture 2
AZ	rap 3
AZIATIX	J-pop
Aaliyah	pop 1
Aaron Carter	pop 1
Aaron Copland	rock
Aaron Johnston, Jesse Murphy & Avi Bortnick	video game music
Aaron Lohr	internet culture
Aaron West and The Roaring Twenties	pop-punk 1
Ab-Soul	rap 3
Abandon All Ships	metalcore 1
Abhi The Nomad	rap 2
Aborted	doom metal
Above & Beyond	trance
Above The Law	rap 1
Above, Below	metalcore 2
Absofacto	indietronica
Absolute Valentine	synthwave
Ace Hood	internet culture 2
Aceyalone	rap 2
Acrania	progressive metal 2
Action Bronson	rap 1
Actobass	music makers 1
Actress	electronica
Adaline	pop 1
Adam Beyer	electronica
Adam Lambert	internet culture 2
Adam Sandler	rap 2
Adam Youngman	indie 1
Adamn Killa	rap 4
Adele	internet culture 2
Adept	metalcore 2
AdhesiveWombat	indietronica
Adolescents	rock
Adore Delano	RuPaul
Adrian Belew	indie 1
Adrian Kwiatkowski	K-pop 1
Adrian Von Ziegler	internet culture 2
Adrianne Lenker	indie 3
Adriano Celentano	internet culture
Adult Jazz	indie 3
Adventure Club	edm 2
Adventure Time	internet culture 2
Adventures	emo
Aeon	alternative metal
Aero Chord	monstercat
Aerosmith	internet culture 2
Aeryk Bacon	spotify
Aesop Rock	rap 2
Afrika Bambaataa	pop 1
Afrojack	edm 2
Afroman	rock
After The Burial	metalcore 2
Afterparty	edm 1
Afu-Ra	rap 3
Against All Authority	rock
Against All Logic	electronica
Against Me!	pop-punk 1
Against The Current	pop 2
Agalloch	alternative metal
Agar Agar	indie 2
Agent Fresco	progressive metal
Ages and Ages	rock
Agnes Obel	indie 1
Agony by Default	doom metal
Agust D	K-pop 1
Ahab	doom metal
Aimer	otacore
Air	indie 1
Air I Breathe, The	metalcore 2
Air Supply	rock
Airbourne	rock
Aja	RuPaul
Akira The Don	politically engaged
Akon	rap 1
Al B. Sure!	rap 2
Al Green	rock
Al Stewart	rock
Alabama 3	internet culture
Alabama Shakes	indie 1
Alan Lomax	jazz
Alan Silvestri	soundtrack
Alan Walker	indietronica
Alanis Morissette	internet culture
Alaska Thunderfuck	RuPaul
Alazka	metalcore 2
Albert Hammond, Jr.	indie 3
Alcest	alternative metal
Alesana	metalcore 1
Alessandro Cortini	electronica
Alessia Cara	pop 1
Alesso	edm 1
Alestorm	rock
Alex Agnew	pop 1
Alex Cameron	indie 2
Alex Ebert	indie 1
Alex G	psychedelic rock
Alex Lahey	pop 1
Alex Starwoda	rap 2
Alex Turner	indie 1
Alexander Lewis	edm 1
Alexandre Desplat	soundtrack
Alexi Murdoch	indie 1
Alexis Neon	alternative metal
Alexisonfire	metalcore 1
Algernon Cadwallader	emo
Algiers	indie 3
Alice Coltrane	jazz
Alice Cooper	rock
Alice Glass	electronica
Alice In Chains	indie 1
Alice Merton	internet culture 2
Alicia Keys	internet culture
Alien Ant Farm	internet culture
Alien Weaponry	rock
Alina Baraz	indietronica
Alina Pash	indie 1
Alison Wonderland	edm 1
Alix Perez	DnB
Alkaline Trio	pop-punk 1
All Get Out	emo
All That Jazz	internet culture 2
All That Remains	metalcore 1
All Them Witches	psychedelic rock
All Time Low	pop-punk 1
All We Are	indie 3
Allah-Las	psychedelic rock
Allan Rayman	indie 2
Allan Thomas	spotify
Allen Toussaint	psychedelic rock
Allie X	pop 3
Alligatoah	Europe
Allison Moorer	indie 1
AllttA	indietronica
Alok	edm 1
Alon Mor	edm 1
Alpha Wolf	metalcore 2
Alphabeat	indie 1
Alphaville	internet culture 2
Altar Of Plagues	doom metal
Alter Bridge	indie 1
AlunaGeorge	edm 1
Alvvays	indie 2
Always Bloom	spotify
Aly & AJ	pop 2
Aly & Fila	edm 2
AmaLee	otacore
Amadou & Mariam	indie 1
Amanda Bergman	Europe
Amanda Palmer	rock
Amaranthe	alternative metal
Amason	indie 2
Amber Rubarth	indietronica
Amber Run	indie 1
Ambientcloud	music makers 1
Ambrosia	indie 1
Ambulance LTD	indie 1
Amebix	alternative metal
Ameer Vann	rap 3
Amen Dunes	indie 2
America	rock
American Football	indie 1
Ameritz - Karaoke	rock
Amesoeurs	doom metal
Amigo the Devil	indie 1
Amii Stewart	rock
Aminé	rap 1
Amir Obe	rap 3
Amnesia Scanner	electronica
Amon Amarth	rock
Amon Tobin	indietronica
Amorphis	alternative metal
Amour Glamour	music makers 1
Amphix	DnB
Amy Macdonald	rock
Amy Shark	pop 2
Amy Winehouse	rock
An Endless Sporadic	progressive metal
Anaal Nathrakh	alternative metal
Anal Cunt	alternative metal
Anamanaguchi	indietronica
Anaquim	psychedelic rock
Anastasia Rizing	spotify
Anathema	alternative metal
Anaïs Mitchell	pop 1
Anberlin	indie 1
And So I Watch You from Afar	psychedelic rock
Anders Björler	progressive metal
Anders Nilsen	internet culture
Anderson .Paak	rap 1
Anderson East	indie 2
Andrea Gibson	internet culture
Andrew Bayer	trance
Andrew Bird	indie 1
Andrew Gold	internet culture 2
Andrew McMahon in the Wilderness	pop 1
Andrew Rannells	internet culture
Andrew Rayel	edm 2
Andrew W.K.	internet culture 2
Andrez Romero	soundtrack
Andy C	DnB
Andy McKee	indie 1
Andy Mineo	rap 1
Andy Shauf	indie 3
Andy Stott	electronica
Ane Brun	indie 1
Anevo	monstercat
Ang Bandang Shirley	Philippines
Angel Haze	rap 1
Angel Olsen	indie 2
Angelmaker	progressive metal 2
Angelo Badalamenti	indie 2
Angels & Airwaves	indie 1
Angerfist	hardstyle
Angus & Julia Stone	indie 1
Angèle	Europe
Ani DiFranco	politically engaged
Animal Collective	indietronica
Animals As Leaders	alternative metal
Anitta	pop 2
Ann Peebles	rap 2
Anna Burch	indie 2
Anna Calvi	indie 3
Anna Kendrick	internet culture
Anna Lunoe	edm 1
Anna Meredith	indie 2
Anna Wise	rap 1
Anna of the North	pop 2
Anna von Hausswolff	psychedelic rock
Annalisa	spotify
Anne-Marie	pop 2
AnnenMayKantereit	Europe
Annie	pop 1
Annie Lennox	rock
Another Sunny Day	indie 3
Ansel Elgort	pop 2
Anthony Green	pop-punk 1
Anthony Hamilton	indie 1
Anthony Ramos	internet culture
Anthony Rapp	internet culture 2
Anthrax	rock
Anti-Flag	pop-punk 1
Antilopen Gang	Europe
Antoine Dodson	internet culture
Anton's Key	rap 1
Antonio Banderas	internet culture
Antonio Vivaldi	rock
Antonín Dvořák	rock
Antwon	rap 3
António Zambujo	psychedelic rock
Antônio Carlos Jobim	indie 1
Any Given Day	metalcore 2
Apartje.	internet culture 2
Apashe	edm 2
Apathy	rap 1
Aperture Science Psychoacoustic Laboratories	internet culture
Apex	DnB
Aphex Twin	indietronica
Aphrodite's Child	indie 1
Apocalyptica	rock
Apollo Brown	rap 3
Apparat	indietronica
Approaching Nirvana	indietronica
April Kelly	internet culture
Apropos	indie 2
Aqua	internet culture
Aqua Eyes	indie 2
Aquilo	pop 2
Aram Khachaturian	rock
Ararur	psychedelic rock
Arca	electronica
Arcade Fire	indie 1
Arcane Roots	alternative metal
Arch Echo	progressive metal
Arch Enemy	alternative metal
Archers Of Loaf	indie 2
Architects	metalcore 1
Archive	indietronica
Archspire	doom metal
Arctic Monkeys	indie 1
Area 11	internet culture 2
Aretha Franklin	rock
Ariana Grande	pop 1
Ariel Pink	indie 2
Aries	rap 1
Arkells	pop 1
Arkona	alternative metal
Armand Van Helden	indietronica
Armin van Buuren	trance
Armor For Sleep	pop-punk 2
Army Of The Pharaohs	pop-punk 1
Arne Domnérus	jazz
Arnocorps	rock
Arovane	electronica
Arrested Development	rock
Arrhythmic	music makers 1
Arrogant Worms	internet culture
Art Blakey	jazz
Art Blakey & The Jazz Messengers	jazz
Art Garfunkel	rock
Arthur Brown	internet culture
Artie Shaw & His New Music	indietronica
Artificial Language	progressive metal
Arvo Pärt	rock
As Cities Burn	metalcore 1
As I Lay Dying	metalcore 1
Asher Roth	internet culture 2
Ashley Johnson	video game music
Ashley Tisdale	progressive metal
Ashtar Command	video game music
Asking Alexandria	metalcore 1
Asobi Seksu	psychedelic rock
Asteroid	psychedelic rock
Astonish	rap 1
Astor Piazzolla	rock
Astrid S	pop 2
Astrix	trance
Astronautalis	indie 1
Astronauts, etc.	indie 1
Astronoid	alternative metal
Astrud Gilberto	indie 1
At Dawn	music makers 1
At The Drive In	pop-punk 1
At The Gates	doom metal
Atena	metalcore 2
Atheist	doom metal
Athletics	indie 2
Atlas Genius	indie 1
Atmosphere	rap 2
Atmozfears	hardstyle
Atoms For Peace	indietronica
Atreyu	metalcore 1
Atrium Carceri	synthwave
Attack Attack!	metalcore 1
Attila	metalcore 1
Au5	monstercat
Audien	indietronica
Audiofreq	hardstyle
Audiomachine	soundtrack
Audioslave	rock
Audiotricz	hardstyle
August Burns Red	metalcore 1
Auli'i Cravalho	internet culture 2
Aunty Donna	internet culture
Aura Blaze	psychedelic rock
Auralnauts	soundtrack
Auras	progressive metal 2
Austen Tayshus	internet culture
Austin Weber	internet culture
Austin Wintory	video game music
Austra	electronica
Austrian Death Machine	internet culture
Autechre	electronica
Autograf	edm 1
Autolux	psychedelic rock
Autre Ne Veut	psychedelic rock
Ava Max	pop 1
Avantasia	alternative metal
Avantdale Bowling Club	rap 3
Avatar	rock
Avelino	grime
Avenged Sevenfold	rock
Average White Band	indie 1
Aversions Crown	progressive metal 2
Aviana	metalcore 2
Aviators	internet culture 2
Avicii	indietronica
Avishai Cohen	jazz
Avril Lavigne	rock
Axwell	edm 2
Axwell /\ Ingrosso	edm 2
Ayreon	progressive metal
Azealia Banks	pop 1
Azedia	monstercat
Azet	rap 2
Azizi Gibson	rap 3
B.B. King	indie 1
B.E.R.	internet culture
B.o.B	politically engaged
BABYMETAL	J-pop
BADBADNOTGOOD	indietronica
BAND-MAID	J-pop
BANKS	pop 1
BBQ Chickens	pop-punk 1
BIGBANG	K-pop 1
BJ The Chicago Kid	rap 3
BLACKPINK	K-pop 1
BOBBY	K-pop 1
BONES	rap 4
BOOTS	rap 1
BOY	indie 1
BRADIO	otacore
BROCKHAMPTON	rap 1
BROHUG	indietronica
BRONCHO	indie 2
BT	trance
BTOB	K-pop 2
BTS	K-pop 1
Baauer	edm 1
Babbletron	politically engaged
Baby Huey & The Baby Sitters	jazz
Back Door Slam	indie 1
Backstreet Boys	rock
Bad Brains	pop-punk 1
Bad Bunny	rap 1
Bad Company UK	DnB
Bad Lip Reading	internet culture
Bad Meets Evil	rap 2
Bad Omens	metalcore 2
Bad Religion	rock
Bad Sounds	indie 3
Bad Suns	indie 2
Bad Wolves	rock
Baddiel, Skinner & Lightning Seeds	politically engaged
Baek A Yeon	K-pop 2
Bag Raiders	internet culture 2
Baha Men	internet culture 2
Baiyon	video game music
Baka Not Nice	rap 3
Balam Acab	indietronica
Balance And Composure	pop-punk 2
Balkans	indie 2
Ball Park Music	pop 1
Balmorhea	psychedelic rock
Baltic House Orchestra	internet culture 2
Baltimore	psychedelic rock
Baltra	electronica
Band of Horses	indie 1
Bangs	rap 2
Barbara Borgelin	spotify
Barclay Crenshaw	edm 1
Barely Alive	edm 2
Barenaked Ladies	internet culture
Barns Courtney	rock
Baroness	alternative metal
Barry White	internet culture
Bas	rap 3
Basement	emo
Basement Jaxx	indietronica
Basenji	indietronica
Basic Channel	electronica
Bass Drum of Death	indie 3
Bass Modulators	hardstyle
Basshunter	internet culture 2
Bassjackers	edm 1
Bassnectar	edm 1
Bastille	rock
Bat For Lashes	indie 1
Bathory	doom metal
Baths	electronica
Battle Beast	alternative metal
Battle Tapes	internet culture 2
Battles	indie 1
Bauhaus	psychedelic rock
Bay Faction	emo
Bayside	pop-punk 1
Bazzi	pop 2
Be'lakor	doom metal
Beach Bunny	emo
Beach Fossils	indie 2
Beach House	indie 2
Beach Slang	indie 3
Beairtle Ó Domhnaill	internet culture
Beak>	psychedelic rock
Beanie Sigel	rap 3
Beans on Toast	indie 1
Bear	rap 1
Bear Hands	indie 1
Bear McCreary	soundtrack
Bear Vs. Shark	indie 1
Beartooth	metalcore 1
Beast	K-pop 2
Beast In Black	alternative metal
Beastie Boys	rock
Beat Driven Insomnia	psychedelic rock
Beat Happening	indie 3
Beautiful Eulogy	politically engaged
Bebe Rexha	pop 2
Beck	rock
Becky G	pop 1
Bedlam Bards	soundtrack
Bedroom	indie 2
Bee Gees	rock
Behemoth	alternative metal
Beirut	indie 2
Belinda Carlisle	rock
Bell Witch	doom metal
Bell X1	indie 1
Belle & Sebastian	indie 2
Bells	psychedelic rock
Belly	rap 3
Belmont	pop-punk 2
Ben Archbold	trance
Ben Caplan	indie 1
Ben Folds	rock
Ben Folds Five	indie 1
Ben Frost	electronica
Ben Harper	indietronica
Ben Howard	indie 1
Ben Khan	pop 2
Ben Platt	internet culture 2
Ben Prunty	video game music
Ben Salisbury	soundtrack
Ben&Ben	Philippines
Benjamin Clementine	indie 3
Benjamin Francis Leftwich	indie 2
Benjamin Tod	indie 1
Benjamin Wallfisch	soundtrack
Benny Benassi	edm 1
Benoît Pioulard	psychedelic rock
Berhana	rap 3
Berlin	rock
Bernard Cribbins	internet culture
Bernard Herrmann	rock
Bert Hearns	rap 2
BertycoX	indietronica
Best Coast	indie 2
Betraying The Martyrs	metalcore 1
Bette Midler	internet culture 2
Betty Davis	jazz
Betty Who	pop 3
Between The Buried And Me	progressive metal
Beulah	indie 2
Beyoncé	rock
Beyond Creation	doom metal
BgA	K-pop 1
Bhad Bhabie	rap 1
Bibio	electronica
Bic Runga	rock
Bicep	electronica
Biffy Clyro	indie 1
Big Audio Dynamite	rock
Big Bill Broonzy	indie 1
Big Black	indie 2
Big Black Delta	indietronica
Big Boi	rap 3
Big Data	rock
Big Gigantic	indietronica
Big Grams	rap 2
Big K.R.I.T.	rap 3
Big L	rap 1
Big Pun	rap 1
Big Sean	rap 1
Big Shaq	internet culture 2
Big Star	indie 1
Big Thief	indie 3
Big Tymers	rap 3
Big Wild	edm 1
Big Wreck	indie 1
Bikini Kill	pop-punk 1
Bilderbuch	Europe
Bill Burr	internet culture
Bill Callahan	indie 2
Bill Conti	pop-punk 1
Bill Cosby	internet culture
Bill Elm & Woody Jackson	video game music
Bill Etten & The Heritage Band	politically engaged
Bill Evans	jazz
Bill Haley & His Comets	rock
Bill Withers	indie 1
Bill Wurtz	internet culture
Billie Eilish	pop 1
Billie Holiday	rock
Billy Bragg	indietronica
Billy Currington	rap 3
Billy Idol	rock
Billy Joel	rock
Billy Lemos	rap 3
Billy Talent	rock
Billy the Fridge	internet culture
Binary Star	rap 1
Bing Crosby	rock
Biosphere	electronica
Birdy	indie 1
Birdy Nam Nam	internet culture
Birocratic	indietronica
Bishop Briggs	pop 1
Biting Elbows	internet culture
Biz Markie	internet culture
Björk	indie 2
Black Books	indie 1
Black Coast	indietronica
Black Dice	indietronica
Black Eyed Peas	rap 2
Black Flag	rock
Black Hippy	rap 3
Black Honey	indie 3
Black Lips	pop-punk 1
Black Milk	rap 3
Black Moth Super Rainbow	indietronica
Black Mountain	psychedelic rock
Black Peaks	metalcore 1
Black Sabbath	rock
Black Sheep	rap 2
Black Star	rap 1
Black Sun Empire	DnB
Black Thought	rap 3
Black Tiger Sex Machine	edm 2
Blackmill	edm 1
Blackstreet	rap 2
Blackway	rap 1
Bladee	rap 4
Blahzay Blahzay	rap 3
Blake	otacore
Blake Neely	soundtrack
Blake Shelton	rock
Blanck Mass	electronica
Blank Banshee	electronica
Blasterjaxx	edm 2
Blaze Foley	indie 1
Blazo	indietronica
Bleachers	pop 1
Bleed From Within	metalcore 2
Blind Guardian	rock
Blind Melon	indie 1
Blind Pilot	indie 1
Bliss n Eso	rap 2
Blitzkrieg	alternative metal
Bloc Party	indie 1
BlocBoy JB	rap 1
Block B	K-pop 2
Blonde Redhead	internet culture
Blondie	rock
Blood Cultures	psychedelic rock
Blood Orange	indie 3
Blood Stain Child	alternative metal
Bloodbath	alternative metal
Bloodhound Gang	internet culture
Blossoms	indie 2
Blue Man Group	rock
Blue October	indie 1
Blue Scholars	indietronica
Blue Sky Black Death	indietronica
Blue Öyster Cult	internet culture
Blues Traveler	rock
Blur	rock
Bo Burnham	internet culture
BoA	K-pop 2
Boards of Canada	indietronica
Bob Dylan	rock
Bob Marley & The Wailers	indietronica
Bob Moses	edm 1
Bob Seger	rock
Bob the Drag Queen	RuPaul
Bob's Burgers	internet culture 2
Bobby Caldwell	indietronica
Bobby Feeno	politically engaged
Bobby McFerrin	internet culture
Bobby Shmurda	rap 1
Bobby Vinton	internet culture
Bobby Womack	indie 1
Bobcat Goldthwait	rock
Body Count	internet culture
Boggie	internet culture
Bohren & Der Club Of Gore	indie 1
Bola	electronica
Bolbbalgan4	K-pop 2
Bolt Thrower	alternative metal
Bomb the Music Industry!	indie 1
Bomba Estéreo	Europe
Bombay Bicycle Club	indie 1
Bombino	indie 1
Bon Iver	indie 1
Bon Jovi	internet culture
Bondo	internet culture
Bone Thugs-N-Harmony	rap 2
Bones	rap 4
Boney M.	rock
Bonggita	synthwave
Bongripper	doom metal
Bonjr	indietronica
"Bonnie ""Prince"" Billy"	indie 1
Bonnie Tyler	internet culture 2
Bonobo	indietronica
Boo shane	music makers 1
Boogarins	Europe
Boogie	rap 3
Boogie Down Productions	rap 2
Booker T. & the M.G.'s	internet culture
Boombox Cartel	edm 2
Boosie Badazz	internet culture
Bootsy Collins	jazz
Bored Nothing	indie 2
Borgeous	edm 2
Borgore	edm 1
Boris	alternative metal
Borknagar	doom metal
Born Of Osiris	metalcore 2
Bosnian Rainbows	indie 1
Boston	rock
Boston Manor	pop-punk 2
Botch	metalcore 1
Botnek	edm 2
Bowling For Soup	rock
Boxcutter	electronica
Boxplot	DnB
Boy Harsher	indie 3
Boys Night Out	pop-punk 2
Boys Noize	edm 1
Boysetsfire	pop-punk 1
Boyz II Men	internet culture 2
Boz Scaggs	rock
Brad Derrick	video game music
Brad Mehldau	jazz
Brad Paisley	internet culture
Brady Mann	psychedelic rock
Braid	emo
Braids	indietronica
Brain	rap 3
Braken	monstercat
Bran Van 3000	indie 1
Brand New	pop-punk 1
Brandi Carlile	pop 1
Brandon Kai	spotify
Branko	psychedelic rock
Brass Against	indie 1
Brave Girls	K-pop 2
Braxton Burks	video game music
Breach	indietronica
Breakbot	indietronica
Breakdown of Sanity	metalcore 2
Breakfast	trance
Breaking Benjamin	rock
Breathe Carolina	edm 2
Brendon Small	alternative metal
Brennan Heart	hardstyle
Bretsil	music makers 1
Brian Eno	indie 1
Brian McKnight	internet culture
Brian Reitzell	soundtrack
Brian Tyler	politically engaged
Brian Wilson	pop 1
Brian Witzig	rap 1
Bridgit Mendler	pop 3
Bright Eyes	indie 1
Brightblack Morning Light	psychedelic rock
Bring Me The Horizon	metalcore 1
Britney Spears	rock
Broadcast	psychedelic rock
Brock Berrigan	indietronica
Brody Dalle	internet culture 2
Broken Bells	indie 1
Broken Note	edm 1
Broken Social Scene	indie 2
Bronski Beat	rock
Broods	pop 1
Brotha Lynch Hung	rap 1
Brother Ali	rap 2
Brother Dege	indie 1
Brothers of Metal	power metal
Brown Bird	indie 1
Brown Eyed Girls	K-pop 1
Bruce Cockburn	rock
Bruce Faulconer	otacore
Bruce Haack	psychedelic rock
Bruce Springsteen	rock
Brujeria	alternative metal
Bruno Mars	internet culture 2
Bruno Pernadas	indie 1
Bryan Adams	rock
Bryan Ferry	rock
Bryan Lewis	politically engaged
Bryson Tiller	rap 1
Bubbles	internet culture
Buckcherry	rock
Buckethead	indie 1
Buddy	rap 3
Buddy Guy	jazz
Bugzy Malone	grime
Built To Spill	indie 1
Bullet For My Valentine	metalcore 1
Bully	indie 3
Bumpin Uglies	indietronica
Bun B	rap 3
Burial	electronica
Burial, Four Tet, Thom Yorke	indie 2
Buried In Verona	metalcore 2
Burlap the Sac	rock
Bury Tomorrow	metalcore 2
Busdriver	rap 1
Bush	rock
Busta Rhymes	rock
Busted	pop 2
Butthole Surfers	rock
Buzzcocks	internet culture
BØRNS	pop 1
C2C	indietronica
C418	internet culture 2
CAN	psychedelic rock
CASISDEAD	grime
CAZZETTE	edm 1
CHANYEOL	K-pop 2
CHIC	rock
CHINCHILLA	rock
CHVRCHES	pop 1
CL	K-pop 1
CLC	K-pop 2
CNT	internet culture
COIN	pop 1
CRUISR	indie 1
CSS	indie 1
CSTVT	emo
CYNE	rap 1
CZARFACE	rap 3
Cable Boy	rock
Cactus Erectus	rock
Caesars	rock
Café Tacvba	Europe
Cage	rap 1
Cage The Elephant	indie 1
Cake	rock
Cakes da Killa	rap 1
Cal Chuchesta	rap 3
Calexico	indie 1
Calibre	DnB
Caligula's Horse	progressive metal
Calum Scott	pop 1
Calvin Harris	indietronica
Calyx	DnB
Calyx & TeeBee	DnB
Cam	indie 1
Cam Meekins	rap 2
Camel	indie 1
CamelPhat	edm 1
Cameron Avery	indie 3
Camila Cabello	pop 2
Camille	Europe
Camille Saint-Saëns	rock
Camo & Krooked	DnB
Camp Cope	emo
Camp Lo	rap 3
Camu Tao	rap 3
Cam’ron	rap 3
Cancer Bats	rock
Candlebox	rock
Candlemass	doom metal
Candy Claws	psychedelic rock
Canned Heat	rock
Cannibal Corpse	rock
Cannibal Ox	rap 1
Cannonball Adderley	jazz
Canti	internet culture
Cap'n Jazz	pop-punk 1
Capcom Sound Team	video game music
Capital Cities	rock
Capitão Fausto	psychedelic rock
Capstan	metalcore 1
Captain Beefheart & His Magic Band	indie 1
Captain Ska	politically engaged
Captainsparklez	video game music
Car Bomb	progressive metal
Car Seat Headrest	indie 2
Caramel	rock
Caramell	internet culture
Caravan	progressive metal
Caravan Palace	internet culture
Carbon Based Lifeforms	indietronica
Carcass	doom metal
Cardi B	pop 1
Caribou	indietronica
Carl Douglas	internet culture
Carl Orff	rock
Carly Comando	internet culture
Carly Rae Jepsen	rock
Carly Simon	rock
Carmen McRae	psychedelic rock
Carmen Twillie	internet culture
Carminho	psychedelic rock
Carnage	rap 3
Carnifex	progressive metal 2
Carnivore	alternative metal
Caro Emerald	indie 1
Caroline Rose	indie 2
Caroline's Spine	internet culture
Carousel	indietronica
Carpenter Brut	indietronica
Carpenters	rock
Cartel	rock
Case & Point	monstercat
Casey	metalcore 2
Casey Edwards	otacore
Casey Veggies	rap 3
Cash Cash	edm 1
Cashmere Cat	edm 1
Casper	Europe
Cass McCombs	indie 3
Casseth	rock
Cassius Clay	soundtrack
Cassius Tae	internet culture
Cast	pop 1
Cat Power	indie 1
Cat Trumpet	rock
Catfish and the Bottlemen	indie 1
Catherine Feeny	pop 1
Catherine Zeta-Jones	internet culture 2
Cattle Decapitation	alternative metal
Causa Sui	psychedelic rock
Cautious Clay	rap 2
Cave	psychedelic rock
Cavetown	indie 1
Cavves	psychedelic rock
Cayucas	indie 2
CeCe Peniston	internet culture 2
CeeLo Green	internet culture
Celestial Aeon Project	indietronica
Celldweller	indietronica
Ceramic Animal	psychedelic rock
Ceschi	rap 2
Cesium Swimsuit	music makers 1
Cezhu	lo-fi
Chad VanGaalen	indie 3
Chade Summerset	lo-fi
Chairlift	pop 1
Chaka Khan	psychedelic rock
Chameleon Circuit	soundtrack
Chance the Rapper	rap 1
Chaos Chaos	internet culture
Charles Aznavour	Europe
Charles Bradley	indie 1
Charles Hamilton	rap 3
Charles Manson	internet culture
Charles Mingus	jazz
Charli Baltimore	rap 2
Charli XCX	pop 2
Charlie Parker	jazz
Charlie Parra del Riego	rock
Charlie Puth	pop 2
Charlotte Gainsbourg	indie 3
Charlotte Martin	pop 1
Charly Bliss	indie 3
Charmian Carr	rock
Chase & Status	edm 1
Chastity Belt	indie 3
Cheat Codes	edm 1
Chelsea Cutler	pop 3
Chelsea Grin	metalcore 2
Chelsea Jade	pop 2
Chelsea Wolfe	indie 2
Cher	pop 1
Cherlene	internet culture
Cherry Glazerr	indie 3
Cherub	indie 1
Cheryl	pop 2
Chesney Hawkes	rock
Chess at Breakfast	psychedelic rock
Chester Watson	rap 3
Chet Baker	jazz
Chet Faker	rock
Chevelle	indie 1
Chicago	rock
Chicane	trance
Chicano Batman	psychedelic rock
Chick Corea	jazz
Chico Buarque	Europe
Chief Keef	rap 3
Childish Gambino	rap 2
Children Of Bodom	alternative metal
Chill Bump	indietronica
Chilly Gonzales	indietronica
Chime	monstercat
Chinese Football	psychedelic rock
Chinese Man	Europe
Chingy	rap 1
Chiodos	metalcore 1
Chip	grime
Chloe x Halle	pop 2
Choker	rap 3
Chon	indie 1
Chris Brown	rap 1
Chris Christodoulou	video game music
Chris Cornell	indie 1
Chris Del Mar	psychedelic rock
Chris Hadfield	internet culture
Chris Huelsbeck	video game music
Chris Isaak	rock
Chris Joss	soundtrack
Chris Knox	Europe
Chris Lake	edm 2
Chris Lilley	soundtrack
Chris Litwa	psychedelic rock
Chris Stapleton	rock
Chris Young	internet culture
Christian Löffler	electronica
Christian Scott aTunde Adjuah	jazz
Christina Aguilera	rock
Christina Grimmie	pop 1
Christina Perri	rock
Christine and the Queens	pop 1
Christopher Jackson	internet culture 2
Christopher Larkin	video game music
Christopher Lee	internet culture
Christopher O'Riley	indie 2
Christopher Tin	internet culture
Christy Moore	indie 1
Chromatics	indie 2
Chrome Sparks	indietronica
Chromeo	indie 1
Chronic	rock
Chubby Checker	internet culture 2
Chumbawamba	internet culture
Church of the Cosmic Skull	psychedelic rock
Ciara	pop 1
Cibo Matto	indie 1
Cigarettes After Sex	indie 1
Circa Survive	pop-punk 1
Circa Waves	indie 2
Circle of Dust	synthwave
Cirez D	trance
Cities Aviv	K-pop 2
Citizen	pop-punk 2
City Morgue	rap 3
City and Colour	indie 1
Civil War	power metal
Clairo	pop 1
Clams Casino	rap 1
Clap! Clap!	indietronica
Claptone	indietronica
Clarence Carter	indie 1
Clarence Clarity	indie 3
ClariS	otacore
Clark	electronica
Classified	rap 2
Classixx	electronica
Claude Debussy	rock
Claude VonStroke	trance
Clean Bandit	pop 2
Clever Girl	psychedelic rock
Clever Rooster	music makers 1
Cliff Martinez	soundtrack
Clifford Brown	jazz
Clint Mansell	soundtrack
Clinton Shorter	internet culture
Clio	psychedelic rock
Clipse	rap 3
CloZee	indietronica
Cloakroom	indie 3
Clockartz	hardstyle
Closure in Moscow	alternative metal
Cloud Cult	indie 1
Cloud Nothings	indie 3
Cloudkicker	progressive metal
Clout Goku	rap 2
Clown Core	rock
Clowns	pop-punk 1
Clutch	rock
Coast Modern	indie 2
CocoRosie	indie 1
Cocteau Twins	indie 2
Coda	otacore
Code Black	hardstyle
Code Orange	metalcore 1
Codeine	indie 2
Coheed and Cambria	indie 1
Coil	pop-punk 1
Cold Chisel	internet culture
Cold War Kids	indie 1
Coldplay	rock
Coleman Hell	pop 1
Colin Hay	indie 1
Colin Stetson	indietronica
Collective Soul	indie 1
Colleen Green	indie 3
College	internet culture
Collin McLoughlin	rap 1
Colonel Claypool's Bucket Of Bernie Brains	indietronica
Colour Haze	psychedelic rock
Columbus	pop-punk 2
Com Truise	indietronica
Combichrist	internet culture 2
Comeback Kid	metalcore 1
Comethazine	rap 3
Commix	DnB
Commodores	internet culture
Common	rap 1
Company Flow	rap 1
Computer Magic	indie 3
Con Bro Chill	internet culture
Conan	doom metal
ConcernedApe	video game music
Concorde	indie 1
Concrete Blonde	rock
Confidence Man	pop 1
Connan Mockasin	psychedelic rock
Conor Oberst	indie 3
Conquer Divide	metalcore 2
Conro	monstercat
Control Machete	rap 2
Converge	metalcore 1
Conway Twitty	indie 1
Cookie Monster	internet culture
Cool Calm Pete	rap 1
CoolCalmMaurice	lo-fi
Coone	hardstyle
Copeland	indie 1
Corbin	rap 1
Corelia	progressive metal
Corey Feldman	rock
Corey Taylor	rock
Corinne Bailey Rae	pop 1
Cornelius	J-pop
Cornershop	rock
Corona	rock
Coroner	doom metal
Corrupt Society	music makers 1
Cortex	rap 1
Cory Wong	jazz
Cosmic Gate	edm 2
Cosmo Pyke	indie 2
Cosmo Sheldrake	indie 1
Cotton Jones	indie 1
Counterparts	metalcore 2
Courtney Act	RuPaul
Courtney Barnett	indie 2
Cousin Stizz	rap 3
Covet	psychedelic rock
Cowboy Mouth	rock
Cracker	rock
Cradle Of Filth	alternative metal
Craft Spells	indie 2
Craig Finn	indie 3
Craig J.	lo-fi
Craig Mack	rap 1
Craig Meighan	psychedelic rock
Craig Morgan	internet culture
Cranius	video game music
Crash and the Boys	internet culture 2
Crass	rock
Crayon Pop	K-pop 1
Crazy Ex-Girlfriend Cast	internet culture 2
Crazy Town	rock
CrazyEightyEight	metalcore 1
Cream	rock
Creature Feature	internet culture
Creed	internet culture 2
Creed Bratton	soundtrack
Creedence Clearwater Revival	rock
Creek Boyz	rap 3
Creeper	pop-punk 1
Criminal Damage	indie 3
Cristina Branco	psychedelic rock
Cristobal Tapia De Veer	soundtrack
Cro	indie 1
Crobot	indie 1
Crosby, Stills, Nash & Young	rock
Crossfaith	metalcore 1
Crowded House	rock
Cruel Youth	pop 2
Crumb	indie 3
Crush 40	video game music
Crusher-P	otacore
Crying	indie 2
Crypsis	hardstyle
Crystal Castles	indie 1
Crystal Fighters	indietronica
Crystal Lake	metalcore 2
Crystal Mad	indie 1
Crystal Waters	indietronica
Crywolf	monstercat
Cuca Roseta	psychedelic rock
Cuco	pop 1
Cuffed Up	rock
Culprate	edm 1
Cult Of Luna	alternative metal
Cults	indie 3
Culture Abuse	indie 3
Culture Shock	DnB
Cunninlynguists	rap 1
Curbi	edm 2
Curren$y	rap 3
Curren$y & Alchemist	rap 3
Current 93	pop-punk 1
Current Value	DnB
Currents	metalcore 2
Cursive	indie 1
Curt De Smoke	rap 1
Curtis Mayfield	rock
Cutting Crew	rock
CyHi The Prynce	rap 3
Cyantific	DnB
Cyn	pop 1
Cyndi Lauper	rock
Cypress Hill	rap 2
Cyranek	internet culture
Céline Dion	rock
Céu	psychedelic rock
Cœur De Pirate	internet culture 2
D Double E	grime
D'Angelo	rap 2
D'alva	psychedelic rock
D-Block & S-te-Fan	hardstyle
D-Sturb	hardstyle
D.D Dumbo	indie 3
D.I.D	indie 2
D.O.A.	pop-punk 1
D.R.I.	alternative metal
D12	pop 1
DAOKO	J-pop
DARKSIDE	indietronica
DAY6	K-pop 2
DC Breaks	DnB
DEAN	K-pop 1
DEVO	internet culture 2
DIIV	indie 2
DILLY DALLY	psychedelic rock
DJ Blyatman	internet culture 2
DJ Envy	video game music
DJ Format	rap 2
DJ Fortify	despacito
DJ Frane	indietronica
DJ Fresh	edm 1
DJ Khaled	internet culture 2
DJ Koze	electronica
DJ Max Star	rap 2
DJ Mehdi	indietronica
DJ Muggs	rap 3
DJ Okawari	indietronica
DJ Quik	rap 3
DJ Rashad	rap 1
DJ Seinfeld	electronica
DJ Shadow	rap 2
DJ Snake	edm 1
DJ Zinc	trance
DMA'S	indie 2
DMX	internet culture 2
DNCE	pop 2
DON BROCO	pop-punk 1
DPR LIVE	K-pop 1
DRAM	rap 1
DREAMCATCHER	K-pop 2
DREAMERS	indie 1
DROELOE	edm 2
DRS	DnB
DVBBS	edm 2
DZ Deathrays	pop 1
Da Tweekaz	hardstyle
DaBaby	rap 1
Daan	indie 2
Dabin	edm 2
Dabrye	rap 1
Dada	rock
Dada Life	edm 2
Daedelus	rap 1
Daft Punk	indietronica
Dagames	video game music
Dagny	pop 3
Dale Hawkins	internet culture
Dalshabet	K-pop 2
Damian Marley	rap 2
Damien Jurado	indie 2
Damien Rice	indie 1
Damon Albarn	indie 1
Dan Auerbach	indie 3
Dan Bull	internet culture
Dan Croll	indie 2
Dan Deacon	indietronica
Dan Le Sac	indie 1
Dan Le Sac vs Scroobius Pip	internet culture
Dan Mason ダン·メイソン	electronica
Dan Milner	rock
Dan Romer	video game music
Dan Salvato	despacito
Dan Terminus	synthwave
Dance Exponents	Europe
Dance Gavin Dance	metalcore 1
Dance With the Dead	indietronica
Danger	edm 1
Danger Doom	rap 2
Danger Incorporated	rap 3
Danger Mouse	indie 1
Dangerkids	metalcore 1
Daniel Avery	electronica
Daniel Bedingfield	indietronica
Daniel Caesar	rap 1
Daniel Deluxe	synthwave
Daniel Ingram	otacore
Daniel Johnston	indie 1
Daniel Licht	soundtrack
Daniel Pemberton	soundtrack
Daniel Tidwell	video game music
Daniela Andrade	indie 1
Danny Baranowsky	video game music
Danny Brown	rap 1
Danny Byrd	DnB
Danny Elfman	soundtrack
Danny L Harle	pop 2
Danzig	rock
Daphni	electronica
Dario Nunez	K-pop 2
Dark Tranquillity	alternative metal
Darkthrone	alternative metal
Daron Malakian and Scars On Broadway	rock
Darondo	indie 1
Darq E Freaker	rap 3
Darren Korb	video game music
Darren Styles	hardstyle
Darude	edm 1
Daryl Hall & John Oates	rock
Dash Berlin	edm 2
Dashboard Confessional	pop 1
Data	rock
Datsik	indietronica
Daughter	indie 1
Daughters	psychedelic rock
Dauwd	electronica
Dave	rap 3
Dave Bixby	psychedelic rock
Dave Brubeck	indie 1
Dave East	rap 3
Dave Grohl	rock
Dave Matthews Band	rock
Dave Porter	soundtrack
Dave Soldier, Komar & Melamid	internet culture
Daveed Diggs	internet culture 2
David Banner	rock
David Bazan	indie 1
David Bowie	rock
David Byrne	indie 2
David Coffin	internet culture
David Cross	internet culture
David Gilmour	rock
David Glen Eisley	internet culture 2
David Gray	indie 1
David Guetta	edm 1
David Hasselhoff	internet culture
David Jeremiah	internet culture
David Maxim Micic	alternative metal
David Rovics	politically engaged
Dawes	indie 1
Dawn Golden	indie 1
Dawn Wall	DnB
Day Wave	indie 2
Daya	pop 2
Days N Daze	pop-punk 1
Dayseeker	metalcore 1
Dbangz	rap 1
De Jeugd Van Tegenwoordig	Europe
De La Soul	rap 1
De Lux	indie 2
De Staat	indie 1
DeBarge	indie 1
Dead & Company	alternative metal
Dead Can Dance	pop-punk 1
Dead Kennedys	politically engaged
Dead Letter Circus	alternative metal
Dead Man's Bones	indie 1
Dead Meadow	psychedelic rock
Dead Or Alive	internet culture
Dead Prez	rock
Dead Sara	indie 1
Deafheaven	alternative metal
Deakin	indie 3
Dean Blunt	indie 3
Dean Lewis	pop 1
Dean Martin	rock
Dean Ween Group	rock
Deap Vally	indie 2
Dear Rouge	indie 1
Dear and the Headlights	indie 2
Death	alternative metal
Death Be Not Proud	music makers 1
Death Cab for Cutie	indie 1
Death From Above 1979	indie 1
Death Grips	rap 1
Deca	rap 1
Declan McKenna	indie 2
Deee-Lite	rock
Deep Forest	indie 1
Deep Purple	rock
Deepchord Presents: Echospace	electronica
Deeper Purpose	internet culture 2
Deer Tick	indie 2
Deerhoof	indie 3
Deerhunter	indie 2
Def Leppard	rock
Defeater	metalcore 2
Defective Sounds of London	psychedelic rock
Deftones	indie 1
Deicide	doom metal
Del The Funky Homosapien	rap 1
Dela	rap 3
Delain	power metal
Delta Heavy	indietronica
Delta Rae	indie 1
Delta Sleep	psychedelic rock
Delta Spirit	indie 1
Deltron 3030	rap 2
Demetri Martin	internet culture
Demi Lovato	pop 2
Demon Hunter	metalcore 1
Demons & Wizards	alternative metal
Dennis De Laat	trance
Dennis Ferrer	indietronica
Denzel Curry	rap 3
Deolinda	psychedelic rock
Deon Custom	monstercat
Deorro	indietronica
Depeche Mode	rock
Depraved Prophets	internet culture 2
Der Tourist	internet culture
Dermot Kennedy	indie 2
Deru	electronica
Desaparecidos	pop-punk 1
Descendents	pop-punk 1
Desiigner	rap 1
Despised Icon	progressive metal 2
Dessa	rap 2
Destroy Boys	indie 1
Destroyer	indie 3
Detektivbyrån	indietronica
Deuce	rap 1
Devendra Banhart	indie 1
DevilDriver	alternative metal
Devin Townsend	alternative metal
Devin Townsend Band	alternative metal
Devin Townsend Project	alternative metal
Devin Wild	hardstyle
Devlin	grime
Dexys Midnight Runners	rock
Diablo Swing Orchestra	alternative metal
Diabo Na Cruz	Europe
Diabolus Exterminus	indie 1
Diamond Construct	metalcore 2
Diamond Head	alternative metal
Diana Ross	rock
Diarrhea Planet	indie 2
Dibbs	indietronica
Dick Dale	internet culture
Diddy	rap 1
Die Antwoord	internet culture
Die Ärzte	Europe
Diet Cig	indie 3
Dieter Goldmann	internet culture
Digable Planets	rap 2
Digital Underground	internet culture
Digitalism	indietronica
Dikembe	emo
Dilated Peoples	rap 1
Dillon Francis	edm 1
Dimension	DnB
Dimitri De Alencar	pop 1
Dimitri Vangelis & Wyman	edm 2
Dimitri Vegas & Like Mike	edm 1
Dimmes	music makers 1
Dinosaur Jr.	indie 1
Dio	alternative metal
Diogo Piçarra	Europe
Dion Timmer	edm 2
Diplo	edm 1
Dire Straits	rock
Direct	monstercat
Dirt Poor Robins	indietronica
Dirty Audio	monstercat
Dirty Heads	indietronica
Dirty Loops	indie 1
Dirty Projectors	indie 2
Dirty South	edm 2
Dirty Vegas	indietronica
Dirtyphonics	edm 2
Disasterpeace	indietronica
Disclosure	indietronica
Disco Inferno	indie 3
Discovery	indietronica
Disfigure	monstercat
Dismemberment Plan	indie 1
Disney Studio Chorus	internet culture
Disperse	progressive metal
Distant City Light	music makers 1
Distorted Harmony	progressive metal
Disturbed	internet culture
Disturbing Tha Peace	internet culture
Dizzee Rascal	rap 2
Dizzi Dulcimer	indie 1
Dizzy Gillespie	jazz
Dizzy Wright	rap 3
Dj Thera	hardstyle
Django Django	indie 2
Dmitri Shostakovich	rock
Do As Infinity	J-pop
Do Make Say Think	psychedelic rock
Doctor P	indietronica
Doctor Who	soundtrack
Doctor.Ca	electronica
Dodge & Fuski	monstercat
Doi Havto	lo-fi
Doja Cat	internet culture 2
Dojo Cuts	rock
Dollar Signs	pop-punk 1
Dolly Parton	rock
Dominique Cooper	pop 1
Domo Genesis	rap 3
Don Caballero	psychedelic rock
Don Diablo	edm 2
Don McLean	internet culture
Don Toliver	rap 3
Don't Hug Me I'm Scared	despacito
Don't Stop or We'll Die	indie 2
Donald Byrd	jazz
Donald Glover	internet culture
Donald Glover & Danny Pudi	internet culture
Donkey Rollers	hardstyle
Donnie Trumpet & The Social Experiment	rap 1
Donny Hathaway	indie 1
Donny Osmond	internet culture 2
Doomsword	doom metal
Doomtree	rap 2
Dorian Electra	RuPaul
Dorothy	rock
Dorothy Ashby	psychedelic rock
DotEXE	monstercat
Doug Stanhope	internet culture
Doughboyz Cashout	K-pop 1
Downlink	edm 1
Dowsing	rap 3
Doyle	rock
Dr. Awkward	internet culture
Dr. Dog	indie 1
Dr. Dre	rap 2
Dr. John	rock
Dr. Lonnie Smith	jazz
Dr. Octagon	rap 2
Dr. Yen Lo	rap 3
Drab Majesty	indie 3
DragonForce	internet culture
Dragons	soundtrack
Drake	rap 1
Drake Bell	rap 1
Draper	monstercat
Dream Death	doom metal
Dream Evil	power metal
Dream Theater	alternative metal
Dream Wife	indie 2
Dredg	indie 1
Drenge	indie 2
Drive Like Jehu	pop-punk 1
Drive-By Truckers	rock
Drop Nineteens	indie 3
Dropgun	edm 2
Dropkick Murphys	internet culture 2
Droptek	monstercat
Drowning Pool	internet culture
Drudkh	doom metal
Drugdealer	indie 3
Dry the River	indie 1
Dua Lipa	pop 2
Dual Core	indietronica
DubVision	edm 2
Dubloadz	monstercat
Duck Sauce	internet culture
Ducktails	indie 3
Duckwrth	rap 3
Duke Dumont	indietronica
Duke Ellington	jazz
Dumbfoundead	rap 1
Dumbo Gets Mad	psychedelic rock
Dunderpatrullen	indietronica
Dune Rats	pop-punk 1
Dungen	psychedelic rock
Duran Duran	rock
Dusky	trance
Duster	psychedelic rock
Dustin Kensrue	indie 1
Dutchman	rap 1
Dwayne Johnson	internet culture 2
Dying Fetus	doom metal
Dylan Locke	despacito
Dylan Wild	rap 1
Dynamite Hack	internet culture
Dynatron	synthwave
Dyro	edm 2
Dyscarnate	doom metal
Dytrip	internet culture 2
Dâm-Funk	psychedelic rock
E-40	rap 1
E-Clips	music makers 1
E-Force	hardstyle
E.B. Spencer	indie 2
E.S. Posthumus	internet culture
E.S.G.	pop-punk 1
EARTHGANG	rap 3
EASYFUN	pop 2
EBZ	despacito
EDEN	monstercat
EDO BOYS	otacore
EGOIST	otacore
EL VY	indie 2
END	metalcore 2
EPMD	rap 1
ERRA	metalcore 2
ESPRIT 空想	electronica
EXID	K-pop 1
EXO	K-pop 1
EXO-CBX	K-pop 2
Eagle-Eye Cherry	rock
Eagles	rap 1
Eagles Of Death Metal	rock
Earl Sweatshirt	rap 1
Earth, Wind & Fire	internet culture 2
Earthless	alternative metal
Earthside	progressive metal
Easy Star All-Stars	indietronica
Eazy-E	rap 2
Ebba Grön	Europe
Ecco2k	rap 4
Echo & the Bunnymen	rock
Echosmith	rock
Ed Harrison	video game music
Ed Sheeran	rock
Edan	rap 1
Eddie Hazel	psychedelic rock
Eddie Vedder	indie 1
Eddy Grant	rock
Editors	indie 2
Edmund Rubbra	rock
Edna Swap	indie 1
Eduard Khil	internet culture
Edvard Grieg	rock
Edward Mewburn	music makers 2
Edward Sharpe & The Magnetic Zeros	indie 1
Edwin Birdsong	internet culture
Eearz	rap 3
Eekkoo	edm 1
Eels	indie 1
Efence	indietronica
Eidola	metalcore 1
Eiffel 65	internet culture
Eilen Jewell	rock
Einstürzende Neubauten	rock
Eivør	Europe
Ekali	edm 2
El Chombo	despacito
El Guincho	indie 1
El Huervo	indietronica
El Ten Eleven	indie 1
El-P	rap 1
Elan Brio	music makers 1
Elbow	indie 3
Elder	doom metal
Elder Brother	pop-punk 2
Electric Guest	indie 2
Electric Light Orchestra	rock
Electric Mantis	edm 1
Electric Six	internet culture
Electric Wizard	alternative metal
Electric Youth	indietronica
Electricsheep42	lo-fi
Electronic	rock
Electus	monstercat
Eleni Foureira	Europe
Eli Degibri	jazz
Eligh	rap 1
Eliot Ash	music makers 1
Elitist	progressive metal 2
Ella Fitzgerald	rock
Ella Mai	pop 2
Elle King	rock
Ellie Goulding	rock
Elliot Moss	indietronica
Elliott Smith	indie 1
Elliphant	edm 1
Ellis D	music makers 1
Elohim	pop 3
Elsiane	indie 2
Elton Britt	internet culture 2
Elton John	rock
Eluveitie	rock
Eluvium	electronica
Elvin Bishop	rock
Elvis Costello	rock
Elvis Costello & The Attractions	rock
Elvis Presley	rock
Elyahu	rap 3
Emancipator	indietronica
Emarosa	metalcore 1
Emeli Sandé	pop 2
Emergency Broadcast Network	rock
Eminem	rap 2
Emitt Rhodes	psychedelic rock
Emma Blackery	pop 2
Emma Ruth Rundle	indie 2
Emmanuel Fratianni	video game music
Emmy The Great	indie 1
Emperor	alternative metal
Emperor X	indie 3
Empire of the Sun	indie 1
Employed To Serve	metalcore 2
Empress Of	pop 2
Emrlds	indie 1
En Vogue	rock
Endemico	synthwave
Engelbert Humperdinck	rock
Enigma	rock
Ennio Morricone	internet culture
Enrights	music makers 1
Enrique Iglesias	pop 1
Ensiferum	alternative metal
Enslaved	doom metal
Enter Shikari	pop-punk 1
Enterprise Earth	progressive metal 2
Entheos	internet culture 2
Enya	rock
Ephixa	monstercat
Epic Rap Battles of History	internet culture
Epica	power metal
Epik High	K-pop 1
Eprom	edm 1
Eptic	edm 2
Equilibrium	power metal
Era Istrefi	pop 1
Eraserheads	Philippines
Erasure	otacore
Eric B. & Rakim	rap 1
Eric Buchholz	video game music
Eric Church	rock
Eric Clapton	rock
Eric Dolphy	jazz
Eric Fernandez 	music makers 1
Eric Idle	internet culture
Eric Nam	K-pop 2
Eric Prydz	edm 1
Erick Sermon	rap 2
Erik Satie	rock
Ernie	rock
Erra	progressive metal 2
Erykah Badu	rap 1
Esbe	indietronica
Escape the Fate	metalcore 1
Escort	indie 1
Eskimo Callboy	metalcore 1
Eskmo	internet culture
Esperanza Spalding	jazz
Estas Tonne	indie 1
Estradasphere	indie 1
Estrons	indie 3
Eternity Forever	alternative metal
Etherwood	DnB
Etran Finatawa	rock
Etta James	rock
Eugene McDaniels	psychedelic rock
Europe	internet culture
Eurythmics	internet culture
Evanescence	internet culture
Eve	internet culture 2
Eve 6	indie 1
Evelyn Evelyn	indie 1
Everclear	indie 1
Every Time I Die	metalcore 1
Everything But The Girl	indietronica
Everything Everything	indie 2
Everything Is Recorded	rap 3
Evidenc-E	rap 1
Evidence	rap 3
Evil Activities	hardstyle
Ex Deo	power metal
Ex Hex	indietronica
Excision	edm 2
Exivious	doom metal
Explosions In The Sky	indie 1
Extermination Dismemberment	metalcore 1
Extreme	rock
Eyedea & Abilities	rap 2
Eyehategod	doom metal
Ezra Furman	pop-punk 1
F.O.O.L	monstercat
FASCINATING AIDA	internet culture
FC Kahuna	indietronica
FEVER 333	metalcore 1
FFS	indie 2
FIDLAR	pop-punk 1
FIESTAR	K-pop 1
FISHER	despacito
FKA twigs	pop 1
FKJ	indietronica
FLOW	otacore
FM-84	synthwave
FRENSHIP	pop 1
FUTURE WHIRL	rap 1
Fabolous	rap 3
Fagan	rap 3
Failure	indie 1
Fair To Midland	indie 1
Fairuz	rock
Faith Hill	internet culture 2
Faith No More	rock
Faithless	indietronica
Fake Blood	indietronica
Fakear	edm 1
Falcom Sound Team jdk	otacore
Falcone	internet culture
Falconer	power metal
Falkenbach	alternative metal
Fall Out Boy	internet culture 2
Falling In Reverse	metalcore 1
Fame on Fire	rap 1
Family Consumer Science	indie 2
Family of the Year	indie 1
Famous Dex	rap 3
Famous Last Words	metalcore 2
Far East Movement	K-pop 1
Farrah Abraham	rock
Fartbarf	internet culture
Fashawn	rap 1
Fastball	rock
Fat Freddy's Drop	indietronica
Fat Joe	rap 2
Fat Tony	pop 1
Fatboy Slim	indietronica
Fates Warning	doom metal
Father John Misty	indie 2
Fathers Children	psychedelic rock
Fatima Yamaha	electronica
Fatlip	rap 2
Fats Waller	jazz
Faul & Wad Ad	rock
Faun	Europe
Faunts	video game music
Faust	psychedelic rock
Fazerdaze	pop 1
Fear, and Loathing in Las Vegas	internet culture 2
Federico Dubbini	rock
Feed Me	edm 1
Feeder	rock
Fei	K-pop 1
Feint	monstercat
Feist	indie 1
Fela Kuti	rap 2
Felix Jaehn	pop 1
Felly	rap 3
Feng Suave	indie 2
Fenix TX	pop-punk 1
Fergie	pop 1
Fern Dells	music makers 1
Ferry Corsten	edm 2
Ferry Corsten presents Gouryella	trance
Fetty Wap	rap 2
Fever Ray	indie 1
Fever the Ghost	internet culture
Fickle Friends	pop 3
Field Medic	indie 3
Fifth Harmony	pop 1
Figure	edm 2
Filter	rock
Final Fantasy	indie 1
Finch	pop-punk 2
Findlay	indie 2
Fink	indie 1
Finntroll	alternative metal
Fiona Apple	indie 1
Fire From The Gods	metalcore 1
Fire! Orchestra	jazz
Firebreather	internet culture 2
Fireworks	pop-punk 2
First Aid Kit	indie 2
Fischerspooner	pop 1
Fishmans	psychedelic rock
Fit For A King	metalcore 2
Fit For An Autopsy	progressive metal 2
Fitz and The Tantrums	rock
Five Finger Death Punch	internet culture
Five Iron Frenzy	indie 1
Flaaurs	internet culture 2
Flamingosis	indietronica
Flatbush Zombies	rap 3
Fleece	indie 2
Fleet Foxes	indie 1
Fleetwood Mac	rock
Fleshgod Apocalypse	alternative metal
Fleur East	rock
Flight Facilities	indietronica
Flight of the Conchords	internet culture
Flite	DnB
Flo Rida	rock
Fload	music makers 1
Floating Points	electronica
Flobots	internet culture
Flogging Molly	internet culture
Florence + The Machine	rock
Florida Georgia Line	rock
Flosstradamus	edm 2
Fluke	indietronica
Flume	edm 1
Fluorescents	otacore
Flux Pavilion	edm 1
FlyByNo	internet culture 2
Flying Lotus	indietronica
Flyying Colours	indie 3
Foals	indie 1
Focus	indie 1
Focus and Attention	Europe
Foliage	rap 1
Folke Nikanor	Europe
Foo Fighters	rock
For The Fallen Dreams	metalcore 2
Foreign Air	rock
Foreign Beggars	edm 1
Foreign Legion	pop-punk 1
Foreigner	rock
Forest Swords	electronica
Forevermore	metalcore 2
Forge	internet culture 2
Forgetting The Memories	metalcore 2
Fort Minor	internet culture
Forth Wanderers	indie 3
Foster The People	indie 1
Fountains Of Wayne	internet culture
Four Tet	electronica
Four Tops	rock
Four Year Strong	pop-punk 2
Fox Stevenson	monstercat
Foxes	pop 2
Foxing	indie 3
Foxpaw	music makers 1
Foxygen	indie 2
Fracmental	music makers 1
France Gall	indie 1
Francesca Michielin	Europe
Francis Bebey	psychedelic rock
Francis and the Lights	rap 1
Francisco Tárrega	indie 1
Frank Klepacki	video game music
Frank Ocean	rap 1
Frank Sartain	Europe
Frank Sinatra	rock
Frank Turner	rock
Frank Zappa	rock
Frankie Cosmos	indie 3
Frankie Goes To Hollywood	internet culture
Frankie Rose	indie 3
Frankie Valli & The Four Seasons	rock
Frankie Yankovic & His Yanks	rock
Franz Ferdinand	indie 1
Franz Liszt	rock
Franz Schubert	rock
Fred Astaire	internet culture
Fred V & Grafix	DnB
Freddie Gibbs	rap 3
Freddie Hubbard	jazz
Freddie King	rock
Free Throw	emo
Freedom Call	power metal
Freescha	electronica
Freestyle	politically engaged
Freestyle Fellowship	rap 3
Freeway	rap 3
French Montana	rap 1
Frenzal Rhomb	K-pop 1
Frequencerz	hardstyle
Friction	DnB
Friendly Fires	indie 1
Frightened Rabbit	indie 2
Frog Eyes	rock
Froggy Fresh	politically engaged
From Autumn To Ashes	psychedelic rock
From First To Last	pop-punk 1
From Indian Lakes	indie 2
From the Flora	rap 2
Front Line Assembly	synthwave
Front Porch Step	pop-punk 1
Frontliner	hardstyle
Frou Frou	indie 1
Fruit Bats	indie 2
Frédéric Chopin	rock
Fuck Buttons	indietronica
Fucked Up	indie 3
Fugazi	rock
Fugees	rap 2
Fujiya & Miyagi	indie 1
Full Eclipse	indie 1
Funkadelic	jazz
Future	rap 3
Future Islands	indie 2
Futuristic	rap 2
Fuzz	psychedelic rock
FÄIS	indietronica
G Herbo	rap 2
G Jones	edm 2
G-DRAGON	K-pop 1
G-Eazy	rap 1
G. Love & Special Sauce	jazz
G.L.O.S.S.	internet culture 2
GAIA	trance
GARNiDELiA	J-pop
GAS	electronica
GDQ	music makers 1
GENTLE LOVE	video game music
GFOTY	pop 2
GFRIEND	K-pop 2
GG Allin	rock
GIRLI	pop 3
GOT7	K-pop 1
GRADES	indie 1
GRiZ	edm 1
GUM	indie 3
GV	rap 3
GZA	rap 2
Gabriel & Dresden	trance
Gabriel Fauré	rock
Gabriella Cilmi	rock
Gabrielle	rock
Gabrielle Aplin	pop 2
Galactic Empire	rock
Galantis	indietronica
Galaxie 500	psychedelic rock
Galimatias	edm 1
Gallant	pop 1
Gallows	pop-punk 1
Games	psychedelic rock
Gammer	edm 2
Gang Gang Dance	psychedelic rock
Gang Of Four	psychedelic rock
Gang Starr	rap 1
Gang of Youths	indie 2
Gangrene	metalcore 1
Gangsta Pat	rap 3
Ganja White Night	edm 1
Garbage	rock
Garden City Movement	indietronica
Gareth Coker	video game music
Gareth Emery	trance
Garfunkel and Oates	internet culture
Garland Jeffreys	pop-punk 1
Garoad	video game music
Garry Schyman	video game music
Gary Clark Jr.	indie 1
Gary Glitter	rock
Gary Jules	internet culture
Gary Moore	indie 1
Gary Numan	indie 1
Gas	indietronica
Gatekeeper	synthwave
Gavin Bryars	indie 1
Gavin Castleton	indie 1
Gayngs	indie 1
Gazpacho	progressive metal
Gemini	edm 1
Gene Farris	internet culture
Genesis	rock
Genghis Tron	alternative metal
Gentle Giant	progressive metal
Gentlemens Club	edm 2
Geo47	rap 3
Geographer	indie 2
George Carlin	internet culture
George Clanton	psychedelic rock
George Ergemlidze	music makers 1
George Ezra	pop 2
George FitzGerald	electronica
George Gershwin	rock
George Harrison	rock
George Jones	rock
George Michael	internet culture
George Strait	rock
George Thorogood & The Destroyers	internet culture
George Winston	rock
Gerard Way	indie 1
Gerry Rafferty	rock
Gesaffelstein	indietronica
Gesu No Kiwami Otome	J-pop
Geto Boys	rock
Getter	edm 1
Ghastly	edm 2
Ghost	rock
Ghost Bath	alternative metal
Ghost Brigade	doom metal
Ghosted	pop 2
Ghostemane	rap 2
Ghostface Killah	rap 3
Ghostland Observatory	indietronica
Ghostpoet	rap 1
Gideon	metalcore 2
Gigi D'Agostino	rock
Gil Scott-Heron	indietronica
Gilbert O'Sullivan	indie 1
Giles Corey	indie 1
Giles Lamb	otacore
Gillian Welch	indie 2
Gin Blossoms	rock
Ginuwine	internet culture 2
Gioachino Rossini	rock
Giorgio Moroder	indietronica
Gipsy Kings	Europe
Giraffage	indietronica
Girl Band	indie 3
Girl Talk	indie 1
Girl Unit	edm 1
Girl's Day	K-pop 1
Girlfriends	emo
Girls	indie 1
Girls Aloud	pop 2
Girls' Generation	K-pop 1
Girls' Generation-Oh!GG	K-pop 2
Girls' Generation-TTS	K-pop 2
Gisela João	psychedelic rock
Give Zombies the Vote	internet culture
Glass Animals	indie 1
Glassjaw	metalcore 1
Glasslands	metalcore 1
Glen Hansard	indie 1
Glenn Stafford	video game music
Glenn Yarbrough & The Limeliters	video game music
Global Communication	indietronica
Gloria Gaynor	internet culture 2
Gloria Jones	indie 1
Gloryhammer	alternative metal
Glue Trip	indie 3
Gmcfosho	internet culture 2
Gnarls Barkley	rock
GoGo Penguin	jazz
Goat	psychedelic rock
Goatwhore	doom metal
Goblin	indietronica
Goblin Cock	alternative metal
God Is An Astronaut	psychedelic rock
Godsmack	rock
Godspeed You! Black Emperor	indie 1
Gogol Bordello	internet culture 2
Gojira	alternative metal
Gold Panda	indietronica
GoldFish	indietronica
GoldLink	rap 3
Golden Earring	rock
Goldfinger	rock
Goldfrapp	pop 1
Goldie	DnB
Goldie Lookin Chain	internet culture
Goldroom	edm 1
Goldstepz	rap 3
Gonjasufi	rap 1
Good Charlotte	rock
Good Kid	indie 2
Good Morning	indie 3
Good Times Ahead	edm 2
GoodQue	indietronica
Goodbye Tomorrow	rap 2
Goodie Mob	rap 3
Goodwill	indietronica
Gopnik McBlyat	internet culture 2
Gordon Lightfoot	internet culture
Gorgon City	edm 1
Gorgoroth	doom metal
Gorguts	doom metal
Gorillaz	indie 1
Gospel	metalcore 1
Gost	synthwave
Gotan Project	indie 1
Gotye	internet culture
Gouryella	trance
Grabbitz	monstercat
Grace Jones	rock
Grace VanderWaal	pop 2
Graduating Life	pop-punk 2
Graeme Norgate	video game music
Grailknights	power metal
Grails	psychedelic rock
Gramatik	indietronica
Grand Magus	alternative metal
Grandaddy	indie 1
Grandayy	despacito
Grandview	pop-punk 2
Grant	edm 2
Grant Bowtie	edm 2
Grant Macdonald	internet culture 2
Grateful Dead	jazz
Grave Digger	power metal
Gravediggaz	rap 1
Graveyard	alternative metal
Grayscale	pop-punk 2
Great Dane	rock
Great White	rock
Green Day	rock
Green Jelly	internet culture
Green River Ordinance	rap 2
Greenleaf	psychedelic rock
Greenskeepers	internet culture
Gregory Alan Isakov	indie 1
Gregory and the Hawk	indie 1
Greta Van Fleet	rock
Grey	edm 1
Greydon Square	politically engaged
Gridlock	electronica
Grieves	rap 2
Grift	doom metal
Grimes	pop 1
Grizzly Bear	indie 1
Groove Armada	indie 1
Group X - Arabian Rap Sensations	internet culture
Grouper	psychedelic rock
Grouplove	indie 1
Grover Washington, Jr.	internet culture 2
Grum	edm 1
Gryffin	edm 2
Gucci Mane	rap 3
Guerilla Toss	indie 3
Guided By Voices	indie 2
Guilhem Desq	internet culture
Guillemots	indie 1
Guilt Machine	progressive metal
Gunna	rap 3
Guns N' Roses	rock
Gunship	indietronica
Gunz For Hire	hardstyle
Guru	rap 1
Gurudutt Perichetla	music makers 1
Gus Dapperton	indie 2
GusGus	indietronica
Gustav Holst	rock
Gustav Mahler	rock
Gustavo Santaolalla	video game music
Guster	psychedelic rock
Gwen Stefani	rock
Gypsy & The Cat	indie 2
H.E.R.	rap 1
HAERTS	indie 3
HAIM	pop 1
HANA	pop 3
HEALTH	indietronica
HEIZE	K-pop 1
HNNY	electronica
HOLYCHILD	pop 3
HOMESHAKE	psychedelic rock
HONNE	pop 1
HOTEI	rock
HS87	rap 3
HYO	K-pop 2
HYUKOH	K-pop 1
Haddaway	internet culture 2
Hail Mary Mallon	rap 2
Hail The Sun	metalcore 1
Hailee Steinfeld	pop 1
Haken	progressive metal
Hako Yamazaki	indietronica
Halestorm	internet culture 2
Haley Heynderickx	indie 3
HalfNoise	pop-punk 1
Hallucinogen	indietronica
Hallucinogenius	rap 1
Halogen	internet culture 2
Halsey	pop 1
Hamitr	indie 1
HammerFall	internet culture 2
Hammock	psychedelic rock
Hands Like Houses	metalcore 1
Handsome Boy Modeling School	rap 2
Hank Williams III	rock
Hannah Diamond	pop 2
Hannes Wader	Europe
Hannibal Buress	internet culture
Hans Zimmer	internet culture
Hanson	internet culture
Harakiri for the Sky	doom metal
Hard Bass School	internet culture 2
Hard Driver	hardstyle
Hard N Low	psychedelic rock
Hardwell	edm 2
Hari Kondabolu	internet culture 2
Harley Poe	pop-punk 1
Harold Rome	internet culture
Harry Belafonte	rock
Harry Chapin	internet culture
Harry Manfredini	indietronica
Harry Nilsson	rock
Harry Styles	pop 1
Haru Nemuri	J-pop
Harvey Danger	rock
Hatchie	indie 3
Hatebreed	rock
Hath	doom metal
Hatriot	indie 1
Have A Nice Life	indie 2
Have Mercy	pop-punk 2
Havok	alternative metal
Hawthorne Heights	pop-punk 1
Hayden James	edm 1
Hayley Kiyoko	pop 2
Haywyre	monstercat
Hazel English	indie 3
He Is Legend	metalcore 1
Headhunterz	hardstyle
Heart	rock
Heart Of A Coward	metalcore 2
Heart Tide	music makers 1
Hechizeros Band	internet culture
Heilung	Europe
Heinz Kiessling	internet culture
Hekler	edm 2
Helion Prime	power metal
Helios	synthwave
Hella	psychedelic rock
Hellberg	monstercat
Hellions	metalcore 1
Hellogoodbye	rock
Helloween	alternative metal
Helmet	rock
Heltah Skeltah	rap 3
Hency	Europe
Henry Jackman	soundtrack
Henry Mancini	rock
Her	indie 1
Her's	indie 3
Herb Alpert & The Tijuana Brass	internet culture
Herbert	electronica
Herbie Hancock	jazz
Here Come The Mummies	indie 1
Here We Go Magic	indie 3
Hermit and the Recluse	rap 3
Hermitude	indietronica
Herobust	edm 2
Hey Violet	pop 2
Hezekiah	indie 1
Hiatus	indietronica
Hiatus Kaiyote	indietronica
Hidden Orchestra	jazz
Hideki Naganuma	video game music
High Contrast	DnB
High On Fire	doom metal
Higher Brothers	rap 1
Highly Suspect	rock
Hikaru Utada	internet culture 2
Hila Ruach	internet culture
Hilary Duff	pop 1
Hilight Tribe	trance
Hillsong UNITED	politically engaged
Hillsong Worship	politically engaged
Hilltop Hoods	rap 2
Hilmar Örn Hilmarsson	internet culture
Himmel	internet culture
Hinds	indie 3
Hippie Sabotage	edm 1
Hippiesindawoodz	rap 2
Hippo Campus	indie 2
Hipster Pug	music makers 2
Hiroaki Tommy Tominaga	otacore
Hiromi	jazz
Hiroyuki Sawano	otacore
Hjálmar	indietronica
Ho - Kago Tea Time	otacore
Ho99o9	rap 1
Hobo Johnson	indie 1
Hockey Dad	indie 2
Hole	rock
Hollow Front	metalcore 2
Holly Herndon	electronica
Hollywood Principle	video game music
Hollywood Undead	rock
Holy Ghost!	psychedelic rock
Holy Holy	indie 3
Holy Terror	doom metal
Home	indietronica
Homeboy Sandman	rap 1
Honeyblood	pop 1
Honeycut	internet culture
Hoobastank	rock
Hookworms	indie 3
Hoops	indie 3
Hootie & The Blowfish	rock
Hooverphonic	indie 1
Hop Along	indie 3
Hopesfall	metalcore 1
Hopsin	rap 1
Horace Silver	jazz
Horse Feathers	indie 1
Horse The Band	rock
Horsepower Productions	edm 1
Horseshoe G.A.N.G.	Europe
Horslips	Europe
Hot Action Cop	internet culture
Hot Chip	indietronica
Hot Dad	internet culture
Houndmouth	indie 2
House Of Pain	internet culture 2
Hovey Benjamin	internet culture 2
How To Dress Well	psychedelic rock
Howard Shore	internet culture
Howlin' Wolf	jazz
Hozier	rock
Hrvrd	pop-punk 1
Hudson Mohawke	edm 1
Huey Lewis & The News	rock
Hugh Hardie	DnB
Hugh Jackman	internet culture 2
Hugh Laurie	rock
Hugh Masekela	rap 2
Hulkoff	power metal
Hum	indie 1
Humanity's Last Breath	progressive metal 2
Humble Pie	rock
Huncho Jack	rap 3
Hundred Waters	indietronica
Hundredth	metalcore 1
Hunned Kay	spotify
Hurts	pop 1
Hybrid	trance
Hybrid Minds	DnB
Hymie's Basement	indie 1
Hyper	video game music
Hyper Potions	monstercat
Hypnotic Brass Ensemble	indie 1
HyunA	internet culture
Hz.	music makers 1
HÆLOS	indie 1
Hüsker Dü	pop-punk 1
I Am Legion	edm 1
I DONT KNOW HOW BUT THEY FOUND ME	pop 1
I Feel Fine	emo
I Fight Dragons	indie 1
I Monster	indie 1
I Prevail	rock
I See Stars	metalcore 1
I The Breather	metalcore 2
I The Mighty	metalcore 1
I'm From Barcelona	indie 1
I, Omega	progressive metal
I.O.I	K-pop 2
IAMDDB	rap 3
IAMX	rock
IC3PEAK	indietronica
ICO	video game music
IDK	rap 3
IDLES	pop-punk 1
IHF	indietronica
ILL Bill	K-pop 1
ILLENIUM	edm 2
ILOVEMAKONNEN	rap 3
INXS	rock
INZO	indietronica
ISIS	alternative metal
IU	K-pop 1
IV Of Spades	rock
IZ*ONE	K-pop 1
Iamjakehill	internet culture 2
Ian Taylor	internet culture 2
Ibeyi	pop 1
Ibrahim	music makers 1
Ibrahim Maalouf	indie 1
Ice Cube	internet culture 2
Ice Nine Kills	metalcore 1
Ice-T	rap 2
IceJJFish	internet culture
Iceage	indie 3
Iced Earth	power metal
Ichiko Aoba	J-pop
Icon For Hire	rock
Icona Pop	pop 2
Ide the Shanty One	internet culture
Idealism	electronica
Idontknowjeffery	rock
If These Trees Could Talk	psychedelic rock
Iggy Azalea	pop 1
Iggy Pop	rock
Iglooghost	electronica
Igor Stravinsky	rock
Igorrr	indietronica
Ihsahn	doom metal
Ikimonogakari	indietronica
Ilan Bluestone	edm 2
Illa J	rap 3
Illicite	music makers 1
Illy	internet culture
Imagine Dragons	internet culture 2
Immolation	doom metal
Immortal	doom metal
Immortal Technique	indie 1
Imogen Heap	rock
Impending Doom	metalcore 1
In Flames	alternative metal
In Hearts Wake	metalcore 2
In Her Own Words	pop-punk 2
In Love With a Ghost	internet culture 2
In My Embrace	doom metal
In The Valley Below	indie 1
In This Moment	rock
Inc.	indietronica
Incendiary	metalcore 1
Incubus	rock
Indigo la End	J-pop
Industries of the Blind	psychedelic rock
Inedia	rock
Infant Annihilator	metalcore 1
Infected Mushroom	indietronica
Infernal	internet culture 2
Ingrid Michaelson	rock
Injury Reserve	rap 3
Innocent	pop-punk 1
Inon Zur	video game music
Inspired Flight	indietronica
Interpol	indie 2
Interstellar Noise	indietronica
Intervals	alternative metal
Intronaut	progressive metal
Invent, Animate	metalcore 2
Irma Thomas	soundtrack
Iron & Wine	indie 1
Iron Butterfly	rock
Iron Chic	emo
Iron Horse	indie 1
Iron Maiden	rock
Iron Reagan	alternative metal
Irreversible Mechanism	doom metal
Isaac Hayes	rock
Isaiah Rashad	rap 3
Isles & Glaciers	metalcore 1
Isotope 217	psychedelic rock
Israel Kamakawiwo'ole	internet culture
Issues	metalcore 1
It Dies Today	metalcore 2
It Looks Sad.	emo
It Prevails	metalcore 2
Ital Tek	electronica
Italian Stallions	politically engaged
Ivan Ave	rap 1
Ivan Gough	edm 1
Ivar Bjørnson & Einar Selvik	alternative metal
Iván Geraldo	spotify
Iyaz	internet culture 2
Izzy Scared	psychedelic rock
J Balvin	pop 1
J Dilla	rap 1
J Hus	rap 3
J Mascis	indie 2
J-MAN	indie 1
J. Boom	lo-fi
J. Cole	rap 1
J.K. The Reaper	rap 3
J.M.K.E.	spotify
J25K	otacore
JAMES SHIMOJI	otacore
JAMIE WEBSTER	politically engaged
JAY-Z	rap 1
JG Thirlwell	internet culture
JID	rap 3
JJ DOOM	rap 1
JJ Project	K-pop 2
JMSN	rap 1
JOJI	rap 1
JONGHYUN	K-pop 2
JOYRYDE	edm 2
JPEGMAFIA	rap 1
JR JR	indie 1
JUR X	electronica
JYOCHO	psychedelic rock
Ja Rule	internet culture 2
Jaala	indie 1
Jack Garratt	pop 1
Jack Harlow	rap 3
Jack Johnson	indie 1
Jack Stauber	indie 1
Jack Stauber's Micropop	indie 1
Jack Wall	video game music
Jack White	indie 1
Jack Ü	indietronica
Jack's Mannequin	rock
Jackie Q	internet culture
Jackson Browne	rock
Jackson C. Frank	indie 1
Jackson Tarricone	internet culture
Jacob Banks	rap 2
Jacob Collier	jazz
Jacques Brel	Europe
Jaden	rap 1
Jaga Jazzist	jazz
Jagwar Ma	indie 3
Jahn Rome	pop 1
Jai Paul	edm 1
Jai Wolf	edm 1
Jake Bugg	indie 2
Jake Chudnow	indietronica
Jake Kaiser	music makers 1
Jake Kaufman	video game music
Jake Paul	internet culture 2
Jake Shimabukuro	indie 1
Jakey	internet culture
Jakman	rap 3
Jakob	psychedelic rock
Jalen Santoy	rap 1
Jam 'n' Slate	indie 3
Jam Baxter	rap 3
Jamaican Queens	indie 2
James	soundtrack
James Arthur	pop 1
James Bay	rock
James Blake	indietronica
James Blunt	internet culture
James Brown	rock
James Brown & The Famous Flames	rock
James Hannigan	internet culture 2
James Holden	electronica
James McAlister	indie 3
James Taylor	rock
James Vincent McMorrow	indie 2
Jamie Christopherson	internet culture 2
Jamie Lawson	internet culture
Jamie Lidell	video game music
Jamie T	indie 2
Jamie xx	indietronica
Jamila Woods	rap 1
Jamiroquai	rock
Jan & Dean	rock
Jan Dismas Zelenka	internet culture 2
Jan Hammer	rock
Jan Jelinek	electronica
Janaitis	rock
Jane Bordeaux	indie 1
Jane's Addiction	rock
Janelle Monáe	pop 1
Janet Jackson	pop 1
Janis Joplin	politically engaged
Japancakes	psychedelic rock
Japandroids	indie 2
Japanese Breakfast	pop 2
Jared Dines	metalcore 1
Jaroslav Beck	internet culture 2
Jase Harley	rap 3
Jason Becker	indie 1
Jason Derulo	rock
Jason Hayes	video game music
Jason Isbell	rock
Jason Isbell and the 400 Unit	rock
Jason Miller	edm 1
Jason Mraz	rock
Jason Richardson	progressive metal 2
Jason Ross	edm 2
Jason Weaver	rock
Jauz	edm 2
Jawbreaker	pop-punk 1
Jax Jones	pop 2
Jay Critch	rap 3
Jay Hardway	edm 2
Jay Park	K-pop 1
Jay Prince	rap 3
Jay Rock	rap 3
Jay Som	indie 3
Jay Sunaway	indietronica
Jaykae	grime
Jaymes Young	rock
Jazz Cartier	rap 3
Jean Sibelius	rock
Jean-Michel Jarre	indietronica
Jebroer	hardstyle
Jedi Mind Tricks	rap 1
Jeezy	rap 3
Jeff Beal	soundtrack
Jeff Buckley	indie 1
Jeff Richmond	internet culture
Jeff Rosenstock	indie 3
Jeff Russo	soundtrack
Jeff Wayne	electronica
Jeff Williams	internet culture 2
Jeffrey Lewis	indie 1
Jellyfish	indie 1
Jemaine Clement	internet culture
Jenni Vartiainen	Europe
Jennifer Lopez	pop 1
Jenny Hval	indie 3
Jens Lekman	indie 2
Jeremiah Jae	rap 3
Jeremih	rap 1
Jeremy Irons	internet culture 2
Jeremy Soule	video game music
Jeremy Zucker	monstercat
Jeremy Zuckerman	internet culture 2
Jerry Douglas	indie 1
Jerry Garcia	jazz
Jerry Garcia Band	jazz
Jerry Goldsmith	internet culture
Jerry Martin	video game music
Jerry Rozz	rap 3
Jeru The Damaja	rap 3
Jesca Hoop	indie 3
Jesper Kyd	video game music
Jess and the Ancient Ones	doom metal
Jesse & Joy	Europe
Jesse McCartney	pop 1
Jesse Novak	internet culture 2
Jesse Stewart	internet culture
Jessica	K-pop 2
Jessie J	pop 2
Jessie Reyez	pop 1
Jessie Ware	pop 1
Jesu	internet culture 2
Jets To Brazil	indie 1
Jewel	pop 1
Jhené Aiko	rap 1
Jidenna	rap 2
Jim Croce	rock
Jim Guthrie	video game music
Jim James	indie 2
Jim Jones	rap 3
Jimi Hendrix	rock
Jimmie's Chicken Shack	indie 1
Jimmy Buffett	rock
Jimmy Eat World	rock
Jinjer	alternative metal
Jinkx Monsoon	RuPaul
Jinsang	indietronica
Jlin	electronica
Jme	rap 1
JoJo	pop 3
Joan Baez	rock
Joana Espadinha	psychedelic rock
Job For A Cowboy	doom metal
Joe Cocker	indie 1
Joe Ford	DnB
Joe Hisaishi	indietronica
Joe Jackson	rock
Joe Pesci	internet culture
Joe Turone	music makers 1
Joe Walsh	rap 3
JoeJas	music makers 1
Joey Bada$$	rap 3
Joey Purp	rap 3
Johan Skugge	video game music
Johan Söderqvist	video game music
Johann Pachelbel	rock
Johann Sebastian Bach	rock
Johann Strauss II	rock
John Adams	rock
John Butler Trio	indie 1
John Carpenter	indietronica
John Coltrane	jazz
John Coltrane Quartet	jazz
John Denver	rock
John Farnham	rock
John Fogerty	rock
John Frusciante	rock
John Grant	pop 1
John Holt	indietronica
John Legend	pop 1
John Lennon	rock
John Luther Adams	rock
John Maus	indie 3
John Mayer	rock
John Mellencamp	politically engaged
John Moreland	indie 1
John Mulaney	internet culture
John Murphy	internet culture
John Paesano	soundtrack
John Popper	rock
John Powell	internet culture 2
John Prine	rock
John Talabot	electronica
John Waite	rock
John Williams	soundtrack
Johnny Cash	rock
Johnny Clegg & Juluka	Europe
Johnny Flynn	indie 1
Johnny Foreigner	indie 1
Johnny Jewel	indie 2
Johnny Mandel	rock
Johnny och Lillemor	rap 1
Joint Venture	Europe
Joji	rap 1
Jojo	internet culture 2
Jon Bellion	pop 1
Jon Benjamin	internet culture
Jon Brion	internet culture 2
Jon Hopkins	electronica
Jon Lajoie	internet culture
Jon Magnusson	spotify
Jon Wilks	psychedelic rock
Jonas Blue	edm 1
Jonathan Coulton	internet culture
Jonathan Groff	internet culture 2
Jonathan Wilson	indie 2
Jonathan Young	internet culture
Jong Sl	music makers 1
Joni Mitchell	psychedelic rock
Jonny Greenwood	indie 2
Jonwayne	internet culture
Jordaan Mason & The Horse Museum	indie 2
Jordan Maston	electronica
Jordi Savall	rock
Joric	spotify
Joris de Man	video game music
Jorja Smith	rap 1
Joryj Kłoc	rap 1
Josef Salvat	indie 1
Joseph	indie 2
Joseph Loduca	internet culture
Joseph Stevenson	rock
Josh Cyrus	music makers 1
Josh Garrels	politically engaged
Josh Homme	indie 2
Josh Ritter	indie 1
Joshua Morse	soundtrack
José González	indie 1
Journey	internet culture 2
Joy Division	rock
Joyce Manor	emo
Joyner Lucas	rap 2
Joywave	indie 1
Ju$tin	rap 1
Juana Molina	psychedelic rock
Judah & the Lion	rock
Judas Priest	rock
Judson Wright	rap 3
Juelz Santana	rap 3
Juice Newton	rock
Juice WRLD	rap 1
Juicy J	rap 1
Jukebox The Ghost	indie 2
Jukio Kallio	K-pop 2
Julia Holter	indie 3
Julia Jacklin	indie 3
Julia Michaels	pop 3
Julian Lage	jazz
Julian Winding	synthwave
Juliano	rap 3
Julie Andrews	internet culture
Julie Byrne	indie 3
Julien Baker	indie 3
Julio Bashmore	electronica
July Talk	indie 1
Jungle	indie 1
Junior Boys	indietronica
Junior Senior	internet culture
Junip	indietronica
Junkie XL	internet culture
Juno Reactor	indietronica
Juno's Touch	music makers 1
Jupi/ter	electronica
Jurassic 5	rap 2
Just A Gent	edm 2
Justice	indietronica
Justice & Metro	rock
Justin Bell	video game music
Justin Bieber	internet culture 2
Justin Hurwitz	soundtrack
Justin Kuritzkes	internet culture
Justin Timberlake	pop 1
Justin Townes Earle	indie 1
Jutrø	indietronica
Jyr3h	indietronica
Jättedam	Europe
Jóhann Jóhannsson	soundtrack
Jónsi	indie 1
Jónsi & Alex	psychedelic rock
K'NAAN	rap 1
K-OS	rock
K.A.A.N.	rap 3
K.Flay	pop 1
K.I.Z	Europe
K1ngsam	alternative metal
KALEO	rock
KANA-BOON	J-pop
KARA	K-pop 2
KARD	K-pop 1
KAUAN	rock
KAYTRANADA	rap 1
KEY!	pop 1
KIDS SEE GHOSTS	rap 3
KILLY	rap 3
KISS	rock
KISSTHECROOK	rap 3
KMD	rap 3
KMFDM	rock
KNK	K-pop 2
KNOWER	internet culture
KOAN Sound	edm 1
KONGOS	rock
KRANE	edm 2
KRS-One	rap 1
KSHMR	edm 2
KSI	rap 1
KT Tunstall	pop 1
KUURO	monstercat
KYLE	rap 1
Ka	rap 3
Kacey Musgraves	pop 1
Kacy Hill	pop 2
Kadavar	psychedelic rock
Kailee Morgue	pop 2
Kairon; IRSE!	psychedelic rock
Kaitlyn Aurelia Smith	electronica
Kaizers Orchestra	indie 1
Kakkmaddafakka	indie 3
Kalafina	otacore
Kaleida	indie 1
Kali Uchis	rap 1
Kalmah	doom metal
Kamasi Washington	jazz
Kamelot	power metal
Kana Hanazawa	otacore
Kano	rap 1
Kansas	internet culture
Kanye West	rap 2
Kap G	rap 3
Karen O	indie 1
Karen Souza	indie 1
Karlheinz Stockhausen	internet culture
Karma Fields	monstercat
Karmin	pop 2
Karnivool	alternative metal
Karpe	Europe
Kasabian	indie 1
Kasbo	edm 2
Kaskade	edm 1
Kat Dahlia	pop 1
Kat Flint	internet culture
Kataklysm	doom metal
Katatonia	alternative metal
Kate Boy	indietronica
Kate Bush	rock
Kate Miller-Heidke	indie 1
Kate Nash	pop 3
Kate Smith	politically engaged
Kate Tempest	rock
Katie Melua	rock
Katy B	pop 1
Katy Perry	internet culture 2
Kavinsky	indietronica
Kay Kay and His Weathered Underground	indie 2
Kay Kyser & His Orchestra	internet culture 2
Kayo Dot	progressive metal
Kayzo	edm 2
Kazuma Jinnouchi	video game music
Keak Da Sneak	indie 1
Keala Settle	soundtrack
Keane	rock
Keaton Henson	indie 1
Keeno	DnB
Keevin	lo-fi
Kehlani	pop 2
Keith Ape	internet culture 2
Keith Mansfield	indie 1
Keith Power	internet culture 2
Kele	indie 1
Kelela	pop 2
Keller Williams	indie 1
Kelly Clarkson	pop 1
Kelly Lee Owens	electronica
Kelly Rowland	pop 1
Kellzy	rock
Kemba	rap 3
Ken Ashcorp	otacore
Ken Nordine	internet culture
Kendra Morris	indie 1
Kendrick Lamar	rap 1
Kenichiro Nishihara	J-pop
Kenny Chesney	rock
Kenny Dope	indietronica
Kenny Loften	rap 3
Kenny Loggins	internet culture
Kensington	indie 1
Kensuke Ushio	otacore
Keos Nabichi	electronica
Keri Hilson	rap 1
Kero Kero Bonito	pop 1
Kero One	indietronica
Kesha	pop 1
Kevin Abstract	rap 1
Kevin Gates	rap 3
Kevin Kiner	soundtrack
Kevin Morby	indie 3
Kevin Penkin	otacore
Kevin Rudolf	rock
Kevin Sodergren Kottonya	music makers 1
Key Glock	Europe
Keys N Krates	edm 1
Khalid	rap 1
Khemmis	doom metal
Khruangbin	psychedelic rock
Kiasmos	electronica
Kid Cudi	rap 2
Kid Indigo	indie 1
Kid Rock	politically engaged
Kidz Bop Kids	pop 2
Kiesza	internet culture 2
Kiev	indie 2
Kiiara	pop 1
Kikagaku Moyo	indie 3
Kill The Noise	indietronica
Killer Mike	politically engaged
Killswitch Engage	metalcore 1
Kilo Kish	pop 2
Kim Carnes	rock
Kim Jung Mi	psychedelic rock
Kim Petras	pop 3
Kimbra	indie 1
King 810	rock
King Buffalo	psychedelic rock
King Creosote	indie 2
King Crimson	indie 1
King Diamond	alternative metal
King Dude	psychedelic rock
King Geedorah	rap 3
King Gizzard & The Lizard Wizard	psychedelic rock
King Krule	indie 2
King Missile	internet culture
King Princess	pop 2
King Tuff	indie 3
Kingdom Of Giants	metalcore 2
Kings of Convenience	indie 1
Kings of Leon	rock
Kingsley	indietronica
Kingston Wall	indie 1
Kink	electronica
Kino	rock
Kinokoteikoku	J-pop
Kirin J Callinan	internet culture 2
Kirsty MacColl	rock
Kishi Bashi	indie 2
Kitashirakawa Tamako (CV: Aya Suzuki)	otacore
Kitten	indie 2
Klamydia	spotify
Klangkarussell	indietronica
Klangstof	indie 3
Klaus Badelt	internet culture
Klaypex	edm 1
Kleerup	rock
Klingande	rock
Knife Party	politically engaged
Knocked Loose	metalcore 1
Knox Fortune	pop 1
Knox Hamilton	indie 2
Knstrktvst	rock
Knuckle Puck	pop-punk 2
Knxwledge	rap 3
Koan	indietronica
Koda	indietronica
Kodak Black	rap 3
Kodaline	rock
Koethe	internet culture 2
Koi Child	rap 2
Kojaque	Europe
Kollektiv Turmstrasse	electronica
Konflict	DnB
Kool & The Gang	internet culture 2
Korn	rock
Korpiklaani	rock
Koven	monstercat
Kraftwerk	rock
Krept & Konan	grime
Krewella	edm 1
Kris Wu	rap 1
Kristofer Maddigan	video game music
Kuana Torres Kahele	internet culture
Kubbi	indietronica
Kublai Khan TX	metalcore 2
Kungs	edm 1
Kurt Vile	indie 2
Kvelertak	alternative metal
Kvist	doom metal
Kwabs	politically engaged
Kweku Collins	rap 1
Kyary Pamyu Pamyu	internet culture
Kygo	edm 1
Kyle Craft	indie 3
Kyle Dixon & Michael Stein	soundtrack
Kyle Kinane	internet culture
Kylie Minogue	pop 1
Kyu Sakamoto	internet culture
Kyuss	alternative metal
Kölsch	electronica
L D R U	edm 2
L'Impératrice	Europe
L'Indécis	electronica
L'Orchestra Cinematique	internet culture 2
LA Project	pop 2
LADIES' CODE	K-pop 2
LADYBABY	internet culture 2
LANDMVRKS	metalcore 2
LANY	pop 2
LAXX	edm 2
LCD Soundsystem	indie 1
LEE HI	K-pop 1
LEISURE	indietronica
LEN	indie 1
LITE	psychedelic rock
LL Cool J	internet culture 2
LMFAO	internet culture
LOMIS	internet culture 2
LOONA	K-pop 1
LP	indie 1
LUCKI	rap 3
LUNA	K-pop 1
LVTHER	monstercat
La Caution	monstercat
La Dispute	pop-punk 1
La Femme	Europe
La La Land Cast	internet culture 2
La Roux	rock
Labi Siffre	rap 2
Lady	internet culture 2
Lady Gaga	rock
Lady Lamb	indie 2
Ladyhawke	pop 1
Ladytron	rock
Laibach	synthwave
Lake Street Dive	pop 1
Lamb of God	alternative metal
Lambchop	indie 3
Lamp	J-pop
Lana Del Rey	rock
Lana Lubany	rock
Lance Skiiiwalker	rap 3
Land of Talk	indie 1
Lander B	rap 3
Landon Tewers	metalcore 2
Lane 8	trance
Langhorne Slim	psychedelic rock
Lantlôs	alternative metal
Lapalux	electronica
Larkin Poe	indie 1
Larry Choppins	lo-fi
Larry Richardson	politically engaged
Larytta	indietronica
Las Ketchup	Europe
Last Dinosaurs	indie 2
Laszlo	monstercat
Late Night Tales	indie 1
Late of the Pier	indie 1
Laura Marling	indie 3
Laura Stevenson	indie 1
Laurel Halo	electronica
Lauren Daigle	rock
Laurie Anderson	rock
Lauv	pop 2
Lawrence	indie 2
Lazerhawk	synthwave
Le Castle Vania	internet culture 2
Le Knight Club	electronica
Le Matos	synthwave
Le1f	pop 2
LeAnn Rimes	internet culture 2
Lea Michele	pop 3
League of Legends	internet culture 2
Leak Bros	rap 1
Lecrae	rap 1
Led Zeppelin	rock
"Lee ""Scratch"" Perry"	indietronica
Lee Fields & The Expressions	indie 1
Leg Puppy	spotify
Leikeli47	rap 1
Lemaitre	indietronica
Lemmino	indie 1
Lemon Demon	internet culture
Lemon Jelly	indie 1
Lena Raine	video game music
Lennie Moore	soundtrack
Lenny Kravitz	rock
Leo	internet culture
Leon Bridges	indie 1
Leon DeChino	rap 2
Leon Vynehall	electronica
Leonard Cohen	rock
Leprous	progressive metal
Lera Lynn	soundtrack
Leroy	soundtrack
Les Misérables - 10th Anniversary Concert Cast	internet culture 2
Les Sins	indietronica
Les Trois Accords	internet culture 2
Lesley Gore	politically engaged
Leslie Odom Jr.	internet culture 2
Less Than Jake	rock
Let's Eat Grandma	indie 3
Lethal Bizzle	grime
Lets Be Friends	monstercat
Lettuce	jazz
Lewis Del Mar	indie 1
Liam Gallagher	indie 3
Liam Hayes	rap 3
Liam Payne	pop 3
Lianne La Havas	indie 1
Liars	indie 2
Lido	edm 2
Life Of Agony	alternative metal
Life Without Buildings	indie 3
Lifeformed	video game music
Lifelike	edm 1
Lightning Bolt	indie 1
Lights	pop 1
Lightspeed Champion	indie 1
Like	rap 3
Like Moths To Flames	metalcore 2
Like Pacific	pop-punk 2
Lil B	rap 1
Lil Baby	rap 3
Lil Boom	politically engaged
Lil Broomstick	internet culture 2
Lil Dicky	rap 2
Lil Keke	rap 1
Lil Kleine	Europe
Lil Maxii	despacito
Lil Mosey	rap 3
Lil Nas X	rap 2
Lil Peep	rap 3
Lil Pump	rap 1
Lil Ray Ray	lo-fi
Lil Scrappy	internet culture 2
Lil Skies	internet culture
Lil Toe	rap 1
Lil Tracy	rap 4
Lil Ugly Mane	rap 3
Lil Uzi Vert	rap 3
Lil Wayne	rap 1
Lil Windex	rap 1
Lil Xan	rap 1
Lil Yachty	rap 3
Lily Allen	rock
Lim Kim	K-pop 1
Limp Bizkit	internet culture
Lin-Manuel Miranda	internet culture 2
Lincoln	pop-punk 1
Linda Martini	psychedelic rock
Lindemann	internet culture
Lindsey Stirling	rock
Linear	DnB
Linearwave	music makers 1
Link Wray	rock
Linked Horizon	otacore
Linkin Park	internet culture 2
Lionel Richie	internet culture 2
Liouville	lo-fi
Liquid Stranger	edm 1
Liquido	rock
Lisa Gerrard	indie 1
Lisa Miskovsky	video game music
Lispector	internet culture
Lissie	indie 1
Listener	indie 1
Lit	rock
Litany	pop 2
Little Big Town	pop 1
Little Comets	indie 2
Little Dragon	indietronica
Little Eva	rock
Little Joy	indie 1
Little Mix	pop 2
Little People	indietronica
Little Richard	rock
Little Simz	rap 3
Little Texas	internet culture 2
Little Tybee	alternative metal
Little V.	otacore
Live	indie 1
Living Colour	politically engaged
Liz Phair	rock
Liza Anne	indie 3
Lizzie Miles	rock
Lizzo	pop 1
Lloyd	rap 1
Lo Moon	indie 2
Loathe	metalcore 2
Local Natives	indie 2
Logan Paul	internet culture
Logic	rap 1
Logistics	DnB
London Elektricity	DnB
London Grammar	indie 1
London Symphony Orchestra	internet culture
Lone	electronica
Long Arm	indietronica
Long Distance Calling	psychedelic rock
Lonnie Liston Smith and the Cosmic Echoes	jazz
Lookas	edm 2
Loona	internet culture
Lord Huron	indie 1
Lord Raid	music makers 1
Lorde	pop 1
Lordi	Europe
Lords Of The Underground	rap 1
Loreen	internet culture 2
Loreena McKennitt	Europe
Lorn	indietronica
Lorna Shore	progressive metal 2
Lorne Greene	rock
Los Brownnies	spotify
Los Campesinos!	indie 1
Los Del Rio	Europe
Loscil	electronica
Lost Frequencies	indietronica
Lost Horizon	alternative metal
Lost In The Trees	indie 1
Lost Kings	edm 2
Lost Notes Society	psychedelic rock
Lost Under Heaven	indie 3
Lotus 	alternative metal
Lotus Plaza	psychedelic rock
Lou Bega	internet culture 2
Lou Gramm	rock
Lou Monte	internet culture 2
Lou Reed	rock
Loud Luxury	edm 1
Loudon Wainwright III	indie 1
Louis Armstrong	internet culture 2
Louis Cole	internet culture
Louis Prima	indie 1
Louis The Child	edm 1
Louis Tomlinson	pop 3
Lovage	indie 1
Love	psychedelic rock
Lovelyz	K-pop 2
Loverboy	rock
Low	indie 2
Low Roar	indietronica
Lower Dens	indie 2
Loyle Carner	rap 1
Lucas & Steve	edm 2
Lucian Piane	RuPaul
Lucie,Too	J-pop
Lucius	rap 2
Luck Mervil	indie 1
Lucki Eck$	rap 3
Lucy Dacus	indie 3
Lucy Rose	indietronica
Ludacris	rap 1
Ludo	indie 1
Ludovico Einaudi	rock
Ludwig Goransson	soundtrack
Ludwig van Beethoven	rock
Luigi Boccherini	rock
Luigi Denza	rock
Luis Fonsi	despacito
Luis Peixoto	psychedelic rock
Lukas Graham	pop 1
Luke Bryan	rock
Luke Combs	rock
Luke Kelly	internet culture
Luna Gala	psychedelic rock
Luna Shadows	pop 3
Lunice	edm 1
Luniz	internet culture 2
Lupe Fiasco	rap 1
Lush	psychedelic rock
Lusine	electronica
Lustra	internet culture
Luther Vandross	rock
Lxmberjack	edm 1
Lykke Li	pop 1
Lynyrd Skynyrd	internet culture 2
LÉON	pop 3
Låpsley	electronica
Lô Borges	Europe
M	indie 1
M. Ward	indie 1
M.I.A.	rap 2
M.R.Clankz	rap 1
M3NYFAC3Z	internet culture 2
M83	indie 1
MAN WITH A MISSION	otacore
MARINA	rock
MASS OF THE FERMENTING DREGS	J-pop
MAX	pop 1
MC Chris	internet culture
MC Fioti	Europe
MC No Limit	internet culture 2
MC Paul Barman	rap 2
MC Rich	spotify
MC5	rock
MCC [Magna Carta Cartel]	indie 1
MDK	monstercat
MDT	electronica
MEUTE	indietronica
MF DOOM	rap 1
MGMT	rock
MIKA	rock
MIKE	rap 3
MINACELENTANO	internet culture
MJx Music	rap 1
MK	indietronica
MKTO	rock
MNEK	pop 3
MOMOLAND	K-pop 1
MONO	psychedelic rock
MOVEMENT	electronica
MRSA	DnB
MS MR	indie 1
MTO	soundtrack
MUNA	pop 3
MUZZ	monstercat
MYRNE	edm 2
MYST	hardstyle
MYTH & ROID	otacore
Maalwe.	lo-fi
Mac DeMarco	indie 2
Mac Miller	rap 3
Mac Murray	music makers 1
Mac Quayle	soundtrack
Machinae Supremacy	video game music
Machine Gun Kelly	rap 1
Machine Head	alternative metal
Machinedrum	electronica
Macho Man Randy Savage	internet culture 2
Macklemore	rap 2
Macklemore & Ryan Lewis	internet culture 2
Mackned	internet culture 2
Maclaine Diemer	video game music
Macy Gray	rock
Mad Caddies	rock
Mad Season	indie 1
Madcon	Europe
Madd	indie 2
Made in Heights	indietronica
MadeinTYO	rap 3
Madeon	indietronica
Madison Mars	edm 2
Madlib	rap 1
Madness	rock
Madonna	rock
Madreblu	soundtrack
Madrepaz	psychedelic rock
Maduk	DnB
Madvillain	rap 1
Mae	pop 1
Mafalda Veiga	indietronica
Maggie Rogers	pop 2
Magic City Hippies	indie 2
Magic Man	indie 1
Magic Sword	indietronica
Magic Wands	indie 2
Magnus Deus	video game music
Majical Cloudz	indie 2
Majid Jordan	rap 3
Major Accident	rap 1
Major Lazer	indietronica
Make Them Suffer	metalcore 2
Makeup And Vanity Set	synthwave
Mako	edm 2
Malaa	edm 2
Malibu Ken	rap 1
Mall Grab	electronica
Maluma	pop 1
Mamamoo	K-pop 2
Man Man	indie 1
Manchester Orchestra	indie 1
Manchester United Boys	politically engaged
Manfred Mann's Earth Band	rock
Manga Saint Hilare	grime
Manic Street Preachers	rock
Manilla Road	power metal
Manny Keep	lo-fi
Manu Chao	rock
Maps & Atlases	indie 2
Marcin Przybyłowicz	video game music
Marco Beltrami	soundtrack
Marconi Union	internet culture
Marcus Marr	indietronica
Marcy Playground	rock
Maren Morris	pop 2
Margaret Glaspy	indie 3
Margo Price	indie 3
Margot & The Nuclear So And So's	rock
Mariachi El Bronx	indie 1
Mariachi Vargas De Tecalitlan	internet culture 2
Mariah	psychedelic rock
Mariah Carey	rock
Mariami	indie 1
Marian Hill	pop 1
Marianas Trench	rock
Marianne Faithfull	rock
Maribou State	electronica
Marika Hackman	indie 3
Marilyn Manson	rock
Marissa Nadler	indie 3
Mariza	psychedelic rock
Mark Knight	edm 2
Mark Knopfler	rock
Mark Lanegan	psychedelic rock
Mark Mothersbaugh	soundtrack
Mark Pritchard	indie 2
Mark Ronson	rock
Mark Rybczynski	lo-fi
Mark Wahlberg	rap 2
Markus Schulz	edm 2
Marlowe	rap 3
Maroon 5	rock
Mars Red Sky	psychedelic rock
Marshmello	edm 1
Marsicans	pop 2
Marta Pereira da Costa	psychedelic rock
Martha	indie 3
Martha Reeves & The Vandellas	rock
Martha Wainright	indie 1
Martin Garrix	edm 2
Martin O'Donnell	video game music
Martin Roth	indietronica
Martin Solveig	indietronica
Marty Muke	rock
Marty Robbins	internet culture 2
Marvin Gaye	internet culture 2
Mary J. Blige	pop 1
Masafumi Takada	otacore
Masakatsu Takagi	otacore
Masego	indietronica
Massive Attack	indie 1
Masta Ace	rap 3
Mastodon	rock
Mat Kearney	politically engaged
Mat Zo	edm 1
Matchbox Twenty	rock
Matisse & Sadko	edm 2
Matisyahu	internet culture 2
Matoma	edm 1
Matrix & Futurebound	DnB
Matroda	edm 2
Matt Berry	indie 1
Matt Corby	indie 2
Matt Lange	trance
Matt Maeson	pop 1
Matt Ox	rap 2
Matt and Kim	pop 1
Matthew Dear	indietronica
Matthew Perryman Jones	jazz
Maty Noyes	pop 3
Maurice Ravel	rock
Max Berg	music makers 1
Max Cooper	electronica
Max Richter	soundtrack
Max Romeo	indie 1
Maxence Cyrin	indie 1
Maximo Park	indie 1
Maximum Impulse Sound System	psychedelic rock
Maxo Kream	rap 3
Maxwell	rap 2
Maybeshewill	psychedelic rock
Mayday	internet culture
Mayday Parade	pop-punk 2
Mazzy Star	indie 2
Mbongwana Star	indie 2
Mc Solaar	Europe
McCafferty	emo
Mcap Steve	video game music
Mcbaise	indie 2
Me & My	Europe
Me First and the Gimme Gimmes	rock
Meat Loaf	internet culture 2
Meat Puppets	rock
Meatbodies	indie 3
Medasin	edm 2
Medeski Scofield Martin & Wood	indie 1
Medeski, Martin & Wood	jazz
Meek Mill	rap 3
Mefjus	DnB
Meg Myers	rock
Mega Drive	synthwave
Megadeth	rock
Megan Thee Stallion	internet culture 2
Meghan Trainor	rock
Meko Supreme	psychedelic rock
Melanie	indie 1
Melanie Martinez	rock
Melano	monstercat
Melleefresh	indietronica
MellowHype	rap 3
Melody's Echo Chamber	psychedelic rock
Melodysheep	internet culture
Melt	indie 2
Melt-Banana	indie 2
Melvins	alternative metal
Memimo Tuati	psychedelic rock
Memphis May Fire	metalcore 2
Men At Work	internet culture 2
Men I Trust	indie 3
Menahan Street Band	jazz
Menomena	indie 1
Mercury Rev	psychedelic rock
Mercyful Fate	alternative metal
Merk & Kremont	indietronica
Merle Haggard	politically engaged
Merle Travis	rock
Meshuggah	alternative metal
Metal Church	doom metal
Metallica	rock
Metalocalypse: Dethklok	rock
Method Man	rap 3
Methyl Ethel	indie 3
Metric	indie 1
Metrik	DnB
Metro Boomin	rap 3
Metro Station	internet culture
Metronomy	indie 1
Metz	indie 3
Mew	indie 2
Miami Horror	indietronica
Miami Nights 1984	internet culture
Michael Barr	metalcore 1
Michael Bublé	pop 1
Michael Cassette	trance
Michael Christmas	rap 1
Michael Fassbender	rock
Michael Giacchino	soundtrack
Michael Gray	Europe
Michael Hunter	indietronica
Michael Jackson	rock
Michael Kiwanuka	indie 2
Michael Manring	indie 1
Michael McCann	video game music
Michael Potts	internet culture
Michael Salvatori	video game music
Michael Wadlow	music makers 1
Michiru Yamane	video game music
Mick Gordon	video game music
Mick Harvey	soundtrack
Mick Jenkins	rap 3
Mickey & Sylvia	rock
Microwave	pop-punk 2
Middle Kids	indie 2
Midlake	indie 1
Midland	electronica
Midnight	doom metal
Midnight Foolishness	emo
Midnight Juggernauts	internet culture
Midnight Odyssey	doom metal
Midnight Syndicate	video game music
Migos	rap 1
Miguel	rap 1
Miguel Araújo	psychedelic rock
Miike Snow	rock
Mija	edm 1
Mike Ault	video game music
Mike Diva	politically engaged
Mike Jones	rap 1
Mike Massé	internet culture
Mike Ness	video game music
Mike Oldfield	rock
Mike Perry	edm 1
Mike Posner	rock
Mike Shinoda	pop 1
Mike WiLL Made-It	rap 3
Mike Williams	edm 2
Mikel	video game music
Mild High Club	psychedelic rock
Miles Davis	jazz
Miles Kane	indie 3
Miles Kang	lo-fi
Miley Cyrus	rock
Mili	otacore
Milky Chance	indie 1
Millencolin	pop-punk 1
Milo	rap 1
Mimicking Birds	indie 3
Mind Over Matter	spotify
Mindless Self Indulgence	rock
Mindseye	music makers 1
Mindsight	indie 1
Mineral	emo
Minerva of the East	music makers 1
Mingus Big Band	jazz
Mini Mansions	indie 3
Mini Swazy	internet culture
Miniature Tigers	indie 2
Minilogue	electronica
Ministry	rock
Mink Mussel Creek	indie 3
Minnie Riperton	indie 1
Minor Threat	rock
Minor Victories	indie 3
Mint Royale	soundtrack
Minus the Bear	indie 1
Minutemen	pop-punk 1
Miracle Musical	indie 1
Miracle Of Sound	internet culture 2
Miranda Cosgrove	pop 2
Mirel Wagner	indie 1
Mirrorish	lo-fi
Misfits	rock
Miss Antidote	music makers 1
Miss Fame	RuPaul
Miss May I	metalcore 2
Missing Persons	rock
Mission Of Burma	indie 3
Mississippi John Hurt	indie 1
Missy Elliott	rap 1
Missy Higgins	pop 1
Mistabishi	DnB
MisterWives	pop 1
Mitch Hedberg	internet culture
Mitch Murder	synthwave
MitiS	edm 2
Mitski	pop 1
Miya Folick	pop 2
Mndsgn	rap 1
Mo-Do	Europe
Mob 47	indie 1
Mobb Deep	rap 1
Moby	indietronica
Modena City Ramblers	Europe
Moderat	indietronica
Modern Baseball	pop-punk 1
Modern Talking	rock
Modest Mouse	indie 1
Modestep	indietronica
Modjo	indietronica
Moguai	trance
Mogwai	indie 1
Moka	video game music
Molemen	rap 1
Molotov	Europe
Mom Jeans.	emo
Momoiro Clover Z	otacore
Mondo Grosso	J-pop
Money Mark	internet culture
Mono	indie 1
Monolord	doom metal
Monsta X	K-pop 2
Monster Truck	internet culture 2
Monstercat	monstercat
Monsters Calling Home	indie 1
Montana of 300	rap 3
Monty Python	internet culture
Monuments	progressive metal 2
Moodoïd	psychedelic rock
Moody Good	edm 2
Moon Boots	trance
Moon Duo	indie 3
Moon Hooch	indie 1
Moon Taxi	indie 2
Moon Tooth	progressive metal
Moonchild	jazz
Moondog	indie 1
Moonspell	Europe
Moose Blood	pop-punk 2
MorMor	indie 3
Morbid Angel	doom metal
Morcheeba	indietronica
Mord Fustang	trance
Morgan Delt	indie 3
Morgen	psychedelic rock
Morphine	indie 1
Morrissey	pop 1
Mos Def	rap 1
Moses Gunn Collective	indie 2
Moses Sumney	indie 3
Moss Icon	indie 1
Moth Equals	indie 2
Mother Mother	indie 1
Mothers	indie 3
Motion City Soundtrack	pop-punk 1
Motionless In White	metalcore 2
Motohiro Hata	internet culture 2
Motoi Sakuraba	video game music
Motorcycle	trance
Motörhead	rock
Mount Eerie	indie 2
Mount Kimbie	electronica
Mount Salem	doom metal
Mountain Man	indie 2
Mousse T.	internet culture
Movements	pop-punk 2
Moving Mountains	pop-punk 1
Movits!	internet culture
Moxoon	music makers 1
Mr FijiWiji	monstercat
Mr Hudson	rap 3
Mr Jukes	indie 2
Mr Little Jeans	indie 2
Mr Twin Sister	psychedelic rock
Mr Weebl	internet culture
Mr. Bungle	indie 1
Mr. Carmack	edm 1
Mr. Garrison, The 3rd Grade Teacher	internet culture 2
Mr. Husband	indie 3
Mr. Muthafuckin' eXquire	rap 3
Mr. Oizo	indietronica
Mr. Probz	indietronica
Mree	internet culture 2
Ms. Lauryn Hill	rap 2
Mt. Eden	edm 1
Mt. Joy	pop 1
Mudhoney	rock
Mudvayne	rock
Mulatu Astatke	jazz
Mumford & Sons	indie 1
Mura Masa	edm 1
Murder By Death	indie 1
Murray Gold	internet culture
Murs	rap 3
Muse	rock
Mustard	rap 3
Mutemath	indie 1
Mutoid Man	alternative metal
Mutual Benefit	indie 3
My Bloody Valentine	indie 1
My Chemical Romance	rock
My Morning Jacket	indie 1
My Sleeping Karma	psychedelic rock
My Vitriol	indie 1
Myd	Europe
Mylo	indietronica
Myrkur	alternative metal
Mystery Skulls	internet culture 2
Mystic Braves	psychedelic rock
Mystk	rock
M|O|O|N	indietronica
MØ	pop 1
Márcia	psychedelic rock
Måns Zelmerlöw	Europe
Mélanie Laurent	indie 1
Mötley Crüe	internet culture 2
Møme	indietronica
N.A.S.A.	rap 2
N.A.S.P.	rap 2
N.E.R.D	rap 1
N.O.R.E.	rap 1
N.W.A.	rap 2
NAIVE	rap 1
NAV	rap 3
NBC	psychedelic rock
NCT	K-pop 1
NCT 127	K-pop 2
NCT DREAM	K-pop 2
NERO	edm 1
NERVO	edm 2
NEU!	psychedelic rock
NF	rap 2
NGHTMRE	edm 2
NIKI	rap 2
NNAMDÏ	rap 3
NOFX	indie 1
NU'EST W	K-pop 2
Nacho Picasso	rap 1
Nada Surf	rock
Nahko And Medicine For The People	indie 1
Nails	alternative metal
NakamuraEmi	otacore
Nana Mizuki	otacore
Nancy Sinatra	rock
Nao	pop 2
Napoleon	metalcore 2
Nas	rap 1
"Nas & Damian ""Jr. Gong"" Marley"	rap 1
Nat King Cole	rock
Natalia Kills	pop 1
Natalia Lafourcade	pop 1
Natalie Imbruglia	rock
Natalie Merchant	rock
Natalie Prass	indie 3
Natalie Venetia Belcon	internet culture
Nathan Fake	electronica
Nathan Lane	internet culture 2
Nathaniel Rateliff & The Night Sweats	rock
Native Construct	progressive metal
Naughty Boy	rock
Naughty By Nature	rap 2
Ne Obliviscaris	alternative metal
Ne-Yo	pop 1
Neal Acree	video game music
Neat Beats	indietronica
Neck Deep	pop-punk 2
Necro	rap 2
Necrophobic	doom metal
Nef The Pharaoh	rap 3
Nehruviandoom	rap 1
Neil Young	rock
Neko Case	pop 1
Nekrogoblikon	alternative metal
Nelix	despacito
Nelly Furtado	pop 1
Nena	rock
Neneh Cherry	indie 2
Neon Indian	indietronica
Neon Nox	synthwave
Nerf Herder	indie 1
Nerina Pallot	pop 1
Netherfriends	indie 3
Netsky	DnB
Netta	politically engaged
Network Music Ensemble	internet culture 2
Neuromonakh Feofan	indie 1
Neutral Milk Hotel	indie 1
Neutralize	rock
Nevermen	electronica
New Found Glory	pop-punk 2
New Order	indie 1
New Radicals	indie 1
New World Sound	internet culture
Niall Horan	pop 3
Nick Cave & The Bad Seeds	rock
Nick Curran and the Lowlifes	indie 2
Nick Dow	indie 1
Nick Drake	indie 1
Nick Hakim	indie 3
Nick Jonas	pop 2
Nick Lutsko	politically engaged
Nick Murphy	indie 3
Nick Warner	music makers 2
Nickel Creek	indie 1
Nickelback	internet culture
Nicki Minaj	rap 1
Nicky Jam	politically engaged
Nicky Romero	edm 2
Nico & Vinz	pop 1
Nico Vega	rock
Nicola Roberts	pop 2
Nicolas Jaar	electronica
Nicole Millar	pop 2
Nigel Good	monstercat
Nigel Stanford	internet culture
Night Beds	psychedelic rock
Night Lovell	rap 1
Night Moves	indie 3
Night Ranger	rock
Night Verses	progressive metal
Nightime Burnout	internet culture
Nightmares On Wax	indietronica
Nightwish	rock
Nile	doom metal
Nile Rodgers	pop 2
Nils Frahm	indietronica
Nils Lofgren	indietronica
Nina Nesbitt	pop 3
Nina Simone	rock
Nine Inch Nails	rock
Nine Treasures	alternative metal
NineFX	indie 1
Ninetoes	electronica
Ningen Isu	rock
Ninja Sex Party	internet culture 2
Nipsey Hussle	rap 3
Nirvana	rock
Nite	music makers 1
Nitro Fun	monstercat
Nmesh	electronica
No Alarms	music makers 2
No Doubt	rock
No Joy	psychedelic rock
No Mana	trance
Noah And The Whale	indie 1
Noah Cyrus	pop 2
Noah Gundersen	indie 1
Nobuo Uematsu	video game music
Noel Gallagher's High Flying Birds	indie 3
Noir Désir	Europe
Noisecontrollers	hardstyle
Noiserv	psychedelic rock
Noisestorm	internet culture 2
Noisia	DnB
Noj	rap 2
Nom Tunes	lo-fi
Nomad Noah	music makers 1
Noname	rap 1
Noordpool Orchestra	indie 2
Norado	lo-fi
Norah Jones	rock
Norm MacDonald	internet culture
Norma Jean	metalcore 2
Norman Greenbaum	rock
Northern Kings	alternative metal
Northlane	metalcore 2
Nosaj Thing	indietronica
Nostromo Pilots	internet culture 2
Notaker	edm 2
Nothing	indie 3
Nothing But Thieves	pop 1
Nothing More	rock
Noumena	doom metal
Novelist	grime
Novelists	metalcore 2
Novel·Fae	music makers 1
November 5	indie 1
Novembers Doom	doom metal
Novo Amor	indie 1
Now, Now	indie 2
Nu:Logic	DnB
Nuages	indietronica
Nucleya	Europe
Nujabes	indietronica
NxWorries	rap 3
Nyre	psychedelic rock
O'Brother	indie 2
O'keefe Music Foundation	indie 1
O-Zone	Europe
O.A.R.	rock
O.E.	rap 1
OCD	music makers 1
ODESZA	edm 1
OG Maco	rap 1
OGRE YOU ASSHOLE	J-pop
OH MY GIRL	K-pop 2
OK Go	internet culture
OM	alternative metal
OMC	internet culture
OMFG	internet culture 2
OMI	rock
ONE OK ROCK	internet culture 2
OOMPH!	internet culture
OPM	internet culture
OSI	progressive metal
OVERWERK	indietronica
Oasis	rock
Oberhofer	indie 2
Occams Laser	synthwave
Ocean Alley	pop 1
Ocean Grove	metalcore 2
Ocean Wisdom	rap 1
Oceano	progressive metal 2
Oceans Ate Alaska	metalcore 2
Oceansize	alternative metal
Odd Mob	internet culture
Oddisee	rap 1
Of Mice & Men	metalcore 1
Of Monsters and Men	rock
Off With Their Heads	pop-punk 1
Offset	rap 1
Oh Hiroshima	psychedelic rock
Oh No	rap 1
Oh Wonder	pop 1
Oh, My.	lo-fi
Oh, Sleeper	metalcore 2
Ohio Players	indie 1
Oingo Boingo	rock
Okkervil River	indie 1
Old & In The Way	indie 1
Old 97's	indie 1
Old Crow Medicine Show	rock
Old Man Saxon	rap 2
Olive	Europe
Oliver	edm 1
Oliver Francis	rap 3
Oliver Heldens	edm 1
Oliver Smith	trance
Oliver Tank	indietronica
Oliver Tree	rap 2
Olivia O'Brien	pop 3
Olivier Libaux	indie 2
Olly Murs	rock
Om Zho	indietronica
Omar Rodriguez Lopez	indie 1
Omega	rap 2
Omega Diatribe	doom metal
Omni	indie 3
Omnia	trance
Omnium Gatherum	doom metal
On An On	indie 2
One Direction	rock
OneRepublic	rock
Oneohtrix Point Never	electronica
Oney	despacito
OnlyM	alternative metal
Onra	rap 1
Ookay	politically engaged
Open Mike Eagle	rap 1
Operation Ivy	rock
Opeth	alternative metal
Ophidian	hardstyle
Opiuo	edm 1
Oppenheimer Analysis	psychedelic rock
Or3o	despacito
Orange Caramel	K-pop 1
Oranssi Pazuzu	doom metal
Orbital	indietronica
Orca Falls	rap 3
Orchards	psychedelic rock
Orchestral Manoeuvres In The Dark	psychedelic rock
Orden Ogan	power metal
Orelsan	Europe
Organized Konfusion	rap 3
Orgy	rock
Origin Unknown	DnB
Original Broadway Cast of Hamilton	internet culture 2
Orjan Nilsen	trance
Orphaned Land	alternative metal
Os Alice	pop-punk 1
Os Velhos	psychedelic rock
Oscar Isaac	rock
Oscar Peterson	alternative metal
Oscar Peterson Trio	jazz
Osker	pop-punk 1
Otherwise	internet culture
Otis Redding	rock
Ott	indietronica
Otter Falls	music makers 2
Ought	indie 3
Our Hollow, Our Home	metalcore 2
Our Lady Peace	rock
Our Last Night	metalcore 1
OutKast	rap 2
Oval	electronica
Overplay	pop-punk 1
Ovlov	indie 3
Owane	alternative metal
Owen	indie 2
Owl City	rock
OxT	otacore
Oxia	electronica
Ozric Tentacles	indie 1
P Money	grime
P!nk	rock
P.E.P.E.	politically engaged
P.O.D.	indie 1
P.O.S	rap 2
PANTyRAiD	edm 1
PARTYNEXTDOOR	rap 3
PENTAGON	K-pop 1
PEZ	rap 2
PHILDEL	pop 1
PHOX	indie 2
PJ Harvey	rock
PNAU	indietronica
PNL	rap 1
POLIÇA	indie 3
POLKADOT STINGRAY	J-pop
PRETTYMUCH	pop 3
PRO ERA	rap 3
PRODUCE 101	K-pop 2
PRhyme	rap 3
PSY	rock
PUP	pop-punk 1
PUSHER TON	internet culture 2
PVRIS	indie 1
PWR BTTM	indie 3
PYLOT	monstercat
PZ	psychedelic rock
Pagan Altar	doom metal
Palace	indie 3
Palace Music	psychedelic rock
Pale Waves	pop 3
Pallbearer	doom metal
Palm	indie 3
Palms	indie 1
Pan-Pot	electronica
Panama	indietronica
Panda Bear	indietronica
Panda Eyes	monstercat
Panda Plane	music makers 1
Panic! At The Disco	rock
Panopticon	alternative metal
Pansy Division	pop-punk 1
Pantera	rock
Pants	music makers 1
Pao	lo-fi
Paolo Buonvino	indie 1
Paolo Meola	indie 2
Paolo Nutini	indie 1
Paolo Sandejas	rap 1
Papa Roach	internet culture
Papadosio	indie 1
Paper Route	indie 3
Paradis	electronica
Paradise Lost	alternative metal
Paradox Interactive	internet culture 2
Paramore	rock
Parasyte	indietronica
Parcels	electronica
Paris Hilton	pop 2
Parkway Drive	metalcore 1
Parliament	rock
Parov Stelar	indietronica
Parquet Courts	indie 3
Parry Gripp	internet culture
Parsonsfield	soundtrack
Part Native	indie 1
Party All Night	internet culture
Party Cannon	rock
Party in Backyard	despacito
Pascal Michael Stiefel	video game music
Passenger	indie 1
Passion Pit	indie 1
Pastor T.L. Barrett	rap 3
Pat Boone	rock
Pat Metheny	indie 1
Pat Metheny Group	jazz
Pat The Bunny	pop-punk 1
Patrick Carney	soundtrack
Patrick Street	indie 1
Patrick Stump	rock
Patrick Watson	indie 3
Patti Page	rock
Patti Smith	rock
Patton Oswalt	internet culture
Patty Gurdy	internet culture
Paul Engemann	internet culture 2
Paul Gilbert	internet culture
Paul Johnson	indietronica
Paul Kalkbrenner	electronica
Paul Kelly	internet culture
Paul Leonard-Morgan	indietronica
Paul McCartney	rock
Paul Robeson	politically engaged
Paul Simon	rock
Paul Stanley	internet culture
Paul Wall	rap 3
Paul van Dyk	trance
Paula Abdul	internet culture
Paus	psychedelic rock
Pavement	indie 2
Pawel Blaszczak	video game music
Paysage D'Hiver	doom metal
Peach Pit	indie 2
Peaches	internet culture
Peake	rap 2
Pearl Jam	rock
Pedro The Lion	indie 3
Peeping Tom	indie 1
Pegboard Nerds	monstercat
Pelican	alternative metal
Pell	rap 3
Pendulum	indietronica
Penguin Cafe Orchestra	indie 1
Pennywise	internet culture 2
Pentakill	internet culture 2
Pentatonix	rock
People Under The Stairs	metalcore 1
Pepe Deluxe	psychedelic rock
Perfume	J-pop
Perfume Genius	pop 1
Periphery	alternative metal
Persefone	doom metal
Perturbator	indietronica
Pet Shop Boys	rock
Pete Rock	rap 3
Pete Rock & C.L. Smooth	rap 2
Pete Shelley	rock
Peter Auty	internet culture
Peter Gabriel	rock
Peter Hollens	video game music
Peter McConnell	video game music
Peter Silberman	indie 3
Petit Biscuit	edm 1
Petri Alanko	video game music
Phaeleh	edm 1
Pham	edm 1
Phantogram	indie 1
Pharmakon	indie 1
Pharoahe Monch	metalcore 1
Pharrell Williams	internet culture 2
Phil Collins	rock
Phil Harris	internet culture
Phil Ochs	politically engaged
Philadelphia Slick	rap 1
Philip Glass	indie 1
Philip Selway	indie 2
Phillip Phillips	rock
Phillipa Soo	internet culture 2
Phinehas	metalcore 2
Phish	indie 1
Phive 6	rap 1
Phoebe Bridgers	indie 3
Phoenix	indie 1
Phony Ppl	rap 1
Phoria	indie 2
Phosphorescent	indie 1
Photay	electronica
Phuture Noize	hardstyle
Phutureprimitive	edm 1
Pia Fraus	indie 3
Pianos Become The Teeth	emo
Pickin' On Series	rock
Picnics at his Adamah!	spotify
Picturesque	metalcore 1
Pierce Fulton	edm 2
Pierce The Veil	metalcore 1
Piersi	Europe
Pigeon Hole	alternative metal
Pigeon John	internet culture
Pigeons Playing Ping Pong	indie 1
Pile	indie 2
Pilot	internet culture
Pilotpriest	synthwave
Pimp C	rap 3
Pinback	indie 1
Pinegrove	indie 3
Pink Ball	internet culture 2
Pink Floyd	rock
Pink Guy	internet culture 2
Pinkshinyultrablast	indie 3
Piotr Musiał	video game music
Pissed Jeans	rock
Pit Z	indietronica
Pitbull	internet culture 2
Pixie Paris	Europe
Pixies	rock
Pixl	monstercat
Pixx	pop 1
Pizza Kids	internet culture
Pkew Pkew Pkew	pop-punk 1
Placebo	indie 1
Plaid	electronica
Plain White T's	rock
Plan B	indie 1
Planxty	Europe
Playboi Carti	rap 3
Player	internet culture 2
Playing For Change	internet culture
Plini	alternative metal
Poe	rock
Poets of the Fall	indie 1
Pogo	rock
Poison The Well	metalcore 1
Pokey LaFarge	rock
Pokémon	internet culture 2
Polaris	metalcore 2
Pold	indietronica
Polvo	psychedelic rock
Polyenso	indie 2
Polyphia	indie 1
Pomegranate Tiger	progressive metal
Pond	psychedelic rock
Poolside	indietronica
Poppy	pop 2
Porches	indie 3
Porcupine Tree	indie 1
Porter Robinson	indietronica
Portico Quartet	jazz
Portishead	indie 1
Portugal. The Man	indie 1
Possessed	doom metal
Post Animal	indie 3
Post Malone	rap 1
Postiljonen	indie 2
Postmark	lo-fi
Pouya	rap 3
Powderfinger	indie 1
Power Glove	synthwave
Power Trip	alternative metal
Powerglove	alternative metal
Powerman 5000	internet culture
Powerwolf	alternative metal
Prefuse 73	indietronica
Preoccupations	indie 3
President T	grime
Pressa	rap 3
Preston School Of Industry	indie 2
Pretend	psychedelic rock
Pretenders	rock
Pretty Lights	indietronica
Pretty Vicious	internet culture 2
Prick	synthwave
Priest	pop 1
Priests	indie 3
Primal Scream	indie 2
Primary	K-pop 1
Primitive Radio Gods	indie 1
Primus	rock
Prince	rock
Prince Daddy & the Hyena	emo
Princess Nokia	rap 1
Princ£ Aureliu$	internet culture
Priscilla Ahn	indie 1
Priscilla Hernández	internet culture
Priscilla Renea	rock
Private Island	indie 2
Prof	rap 2
Professor Elemental	internet culture
Project 46	monstercat
Project Destati	otacore
Project One	hardstyle
Project Revise	alternative metal
Proleter	indietronica
Propagandhi	rock
Propellerheads	internet culture
Prophets Of Rage	politically engaged
Protest The Hero	alternative metal
Protomartyr	indie 3
Protostar	monstercat
Prurient	electronica
Pryda	trance
Psychedelic Porn Crumpets	psychedelic rock
Psychostick	rock
Psycroptic	doom metal
Psyko Punkz	hardstyle
Public Enemy	rap 2
Public Service Broadcasting	internet culture
Puddle Of Mudd	rock
Puffy AmiYumi	internet culture 2
Pulp	rock
Pulse Modulators	psychedelic rock
Punch Brothers	indie 1
Punk Shop Boys	indie 1
Puppet	monstercat
PurNie	music makers 1
Purify	indie 1
Purity Ring	indietronica
Purple Disco Machine	indie 2
Puscifer	rock
Push	trance
Pusha T	rap 3
Pussy Riot	politically engaged
Pyongyang Gold Stars	internet culture
Pyotr Ilyich Tchaikovsky	rock
Q And Not U	pop-punk 1
Q Lazzarus	rock
Q Money	internet culture
Q-Tip	rap 3
QUIX	edm 2
Qartel	rap 3
Quad City DJ's	internet culture 2
Quality Control	rap 3
Quasimoto	rap 1
Quavo	rap 3
Queen	internet culture
Queen Latifah	rap 2
Queens of the Stone Age	rock
Queensrÿche	rock
Quest	Philippines
Quicksand	pop-punk 1
Quicksilver Messenger Service	psychedelic rock
Quiet Riot	internet culture
Quilll	psychedelic rock
Quincy Jones	indie 1
Quindon Tarver	internet culture
Quinn XCII	pop 1
Quintino	edm 2
Qveen Herby	pop 3
R. Kelly	pop 1
R.A. The Rugged Man	rap 3
R.E.M.	rock
R.L. Burnside	jazz
R3HAB	edm 2
R47	video game music
RAC	indietronica
RADWIMPS	otacore
RAINBOW	K-pop 2
RAT BOY	indie 2
REO Speedwagon	rock
RG	music makers 1
RIN	Europe
RIOT	edm 2
RITUAL	metalcore 2
RJD2	indie 1
RL Grime	edm 2
RM	K-pop 1
ROAM	pop-punk 2
ROSALÍA	pop 1
RY X	indie 2
Ra Ra Riot	indie 1
Rachel Platten	pop 2
Radical Face	indie 1
Radical Redemption	hardstyle
Radio Moscow	psychedelic rock
Radiohead	indie 1
Radkey	pop-punk 1
Rae Morris	pop 1
Rae Sremmurd	rap 1
Raekwon	rap 3
Raffi	internet culture
Rag'n'Bone Man	internet culture 2
Rage Against The Machine	politically engaged
RageMD	spotify
Rainbow	K-pop 1
Rainbow Kitten Surprise	indie 2
Raise	electronica
Raised Fist	alternative metal
Raito	otacore
Rakim	rap 3
Raleigh Ritchie	soundtrack
Ralph Vaughan Williams	rock
Rameses B	monstercat
Ramin Djawadi	soundtrack
Ramirez	rap 3
Rammstein	internet culture 2
Ramones	rock
Ran-D	hardstyle
Rancid	rock
Randy Newman	internet culture 2
Rank 1	trance
Raphael Saadiq	rock
Rapsody	rap 3
Raquel Tavares	psychedelic rock
Rare Americans	rock
Rarity	pop-punk 2
Ras Kass	rap 3
Rascal Flatts	rock
Rasputina	internet culture
Ratatat	rock
Rationale	indie 2
Raubtier	alternative metal
Raul Seixa	Europe
Raury	rap 1
Ravyn Lenae	rap 1
Ray Charles	rap 2
Ray LaMontagne	indie 1
Ray Volpe	edm 2
Raymond Scott	internet culture
Rayzd	internet culture 2
Razihel	monstercat
Razorlight	indie 2
Real Estate	indie 2
Real Friends	pop-punk 2
Real Life	rock
Reba McEntire	rock
Rebecca Black	internet culture
Rebelution	indietronica
Recondite	electronica
Red	rock
Red Fang	rock
Red Hot Chili Peppers	rock
Red House Painters	indie 1
Red Rider	rock
Red Sparowes	psychedelic rock
Red Velvet	K-pop 1
Red Vox	otacore
Redbone	internet culture
Reddmond & Joey	music makers 1
Redman	rap 1
Reel Big Fish	rock
Reflections	metalcore 2
Refused	rock
Reggie And The Full Effect	pop-punk 1
Regina Spektor	indie 1
Rejjie Snow	rap 3
Relient K	indie 1
Remo Drive	emo
Rentokill	indie 2
Reol	J-pop
Reso	DnB
Retch	rap 3
Retrology	music makers 1
Reuben	indie 1
Revis	indie 1
Revocation	doom metal
Rex Orange County	indie 2
Rezonate	monstercat
Rezz	edm 1
Rhye	indie 2
Rich Brian	rap 2
Rich Gang	rap 1
Rich Homie Quan	rap 1
Rich The Kid	rap 3
Richard Cheese	internet culture
Richard Dawson	indie 3
Richard Edwards	indie 3
Richard Marx	rock
Richard Strauss	rock
Richard Wagner	internet culture
Richie Havens	rock
Rick Astley	internet culture
Rick James	rock
Rick Moranis	internet culture
Rick Ross	rap 3
Rick and Morty	internet culture
Rickyxsan	edm 2
Rico Nasty	rap 3
Ride	psychedelic rock
Ridiculon	video game music
Riff Raff	rap 1
RiffShop	otacore
Rigid Moods	pop 1
Rihanna	rock
Rilo Kiley	indie 1
Rina Sawayama	pop 3
Rings of Saturn	progressive metal 2
Ripping Corpse	doom metal
Rise Against	indie 1
Rise Of The Northstar	metalcore 1
Rita Ora	pop 2
Rites of Spring	pop-punk 1
Rival Consoles	electronica
Rivers Cuomo	indie 3
Rivers of Nihil	progressive metal
Rixton	rock
Roadrunner United	doom metal
Rob $tone	rap 1
Rob Bailey & The Hustle Standard	rock
Rob Base & DJ EZ Rock	rock
Rob Dougan	indietronica
Rob Lynch	pop 1
Rob Mitchelson	electronica
Rob Scallon	indie 1
Rob Thomas	rock
Rob Zombie	internet culture
Robbie Williams	internet culture 2
Robert DeLong	indie 1
Robert Glasper Experiment	indietronica
Robert Miles	indietronica
Robert Palmer	rap 1
Robert Parker	synthwave
Robert Plant	rock
Robert Wyatt	indie 2
Robin Beanland	video game music
Robin Schulz	indietronica
Robin Williams	internet culture
Robot Koch	indietronica
Robotaki	edm 2
Robyn	pop 1
Roc Marciano	rap 3
Rockabye Baby!	indie 2
Rocket From The Tombs	pop-punk 1
Rockie Gold	internet culture
Rockwell	internet culture
Rocky Orchestra	internet culture
Rod Stewart	rock
Roddy Ricch	rap 1
Rodrigo Amarante	Europe
Rodrigo y Gabriela	indie 1
Roger Waters	indie 1
Rogue	monstercat
Rogue Wave	indie 1
Roky Erickson	indie 1
Rolling Blackouts Coastal Fever	indie 3
Rolo Tomassi	metalcore 1
Ron Gallo	indie 3
Ronald Jenkees	internet culture
Rone	edm 1
Ronnie Drew	rock
Roosevelt	indietronica
Rootkit	monstercat
Rose Elinor Dougall	pop 1
Ross from Friends	electronica
Rostam	indie 3
Rotting Christ	alternative metal
Route 94	indietronica
Roxette	rock
Roxy Music	rock
Roy Blair	pop 1
Roy Brown	internet culture
Roy Buchanan	indie 1
Roy Jones Jr.	rap 2
Roy Orbison	rock
Roy Woods	rap 3
Royal Blood	indie 1
"Royce Da 5'9"""	rap 3
Rozwell Kid	indie 3
Rrose	electronica
RuPaul	RuPaul
Rubblebucket	indie 2
Ruby Ibarra	rap 1
Rucka Rucka Ali	politically engaged
Rudimental	indietronica
Rudovsky	K-pop 1
Ruff Sqwad	grime
Run The Jewels	rap 2
Run–D.M.C.	rock
Rupert Gregson-Williams	soundtrack
Rupert Holmes	internet culture
Rush	rock
Rusko	edm 1
Russ	rap 1
Russian Circles	alternative metal
Rusted Root	indie 1
Rustie	rap 1
Rusty Cage	politically engaged
Ruth B.	pop 1
Rx Bandits	indie 1
Ryan Adams	indie 1
Ryan Chin	rock
Ryan Gosling	internet culture 2
Ryan Paris	indie 1
Rymdreglage	internet culture
Ryn Weaver	pop 1
Ryuichi Sakamoto	indie 1
RÜFÜS DU SOL	edm 1
Röyksopp	indietronica
S U R V I V E	indietronica
S.P.Y	DnB
S3RL	internet culture 2
SAINt JHN	rap 3
SALES	indie 2
SAYGRACE	rock
SBTRKT	indietronica
SCNDL	monstercat
SEGA SOUND TEAM	video game music
SEJEONG	K-pop 2
SEUNGRI	K-pop 1
SEVENTEEN	K-pop 2
SG Lewis	edm 1
SHINee	K-pop 2
SHISHAMO	J-pop
SIAMES	internet culture 2
SIE Sound Team	video game music
SIR E.U	indie 2
SISTAR	K-pop 1
SLANDER	edm 2
SLUMBERJACK	edm 2
SMLE	monstercat
SNAP!	internet culture
SOB X RBE	rap 3
SOHN	indietronica
SOJA	indietronica
SOPHIE	pop 2
SSIO	Europe
STARSET	rock
STRFKR	indie 1
STS9	indie 1
STUDIO TRAM	otacore
SUNMI	K-pop 1
SUPER JUNIOR	K-pop 2
SWMRS	indie 3
SXTN	Europe
SZA	rap 1
Saba	rap 3
Sabaton	internet culture 2
Sabrina Carpenter	pop 3
Sabrina Claudio	pop 3
Sadistik	indie 1
Saetia	pop-punk 1
Safri Duo	Europe
SahBabii	rap 3
Said The Whale	indie 2
Said the Sky	edm 2
Saigon	indietronica
Saint Motel	rock
Saint Vitus	doom metal
Saintseneca	indie 3
Sakanaction	J-pop
Salem	indietronica
Saliva	internet culture
Salt-N-Pepa	rock
Salto	psychedelic rock
Salvador Sobral	Europe
Sam & Dave	rock
Sam Cooke	rock
Sam Feldt	edm 1
Sam Fonteyn	internet culture
Sam Gellaitry	edm 1
Sam Roberts Band	rap 2
Sam Smith	pop 2
Sam Sparro	internet culture 2
Samiyam	indietronica
Sampha	rap 1
Samsa	indie 2
Samsara Blues Experiment	psychedelic rock
Samuel Barber	soundtrack
Samuel Uria	psychedelic rock
San Cisco	indie 1
San Fermin	indie 2
San Holo	edm 2
Sander van Doorn	edm 1
Sango	rap 3
Santa Esmeralda	internet culture
Santana	rock
Santigold	indie 1
Saosin	metalcore 1
Sara Bareilles	rock
Sarah Jaffe	indie 1
Sarah McLachlan	internet culture 2
Sarah P.	indie 2
Sarah Schachner	video game music
Saros-FM	music makers 1
Sasha	trance
Sasha Sloan	pop 2
Sasha, Benny y Erik	internet culture
Sasori	music makers 1
Saturn Will Not Sleep	rap 1
Sauce Walka	rap 1
Saul Williams	indie 1
Savage Garden	rock
Savages	psychedelic rock
Savant	monstercat
Savatage	alternative metal
Saves The Day	emo
Savlonic	indietronica
Savoy	monstercat
Savvy Kray	internet culture 2
Sawbé	rap 1
Say Anything	pop-punk 1
Say Lou Lou	pop 1
Say Sue Me	indie 3
ScHoolboy Q	rap 1
Scala & Kolacny Brothers	rock
Scale The Summit	alternative metal
Scandroid	synthwave
Scanner	power metal
Scar Symmetry	doom metal
Scarface	rap 1
Scarlett Johansson	indie 1
Scarlxrd	rap 3
Scary Kids Scaring Kids	metalcore 1
Scatman John	internet culture
Scattle	indietronica
School Of Seven Bells	indie 2
Scissor Sisters	rock
Scooter	internet culture 2
Scorpions	internet culture 2
Scott Bradlee's Postmodern Jukebox	rock
Scott Joplin	internet culture
Scott Walker	indie 1
Scottie Kash	pop 2
Scotty Sire	rock
Scratch21	internet culture 2
Screamin' Jay Hawkins	indie 1
Screaming Females	indie 2
Scribes	otacore
Scritti Politti	rock
Seafret	indie 1
Seal	internet culture
Sean Dagher	video game music
Sean Hayes	indie 1
Sean Paul	edm 1
Sean Price	rap 3
Sean Will	rap 3
Seaway	pop-punk 2
SebastiAn	edm 1
Sebastian Ingrosso	edm 1
Secede	electronica
Secret & Whisper	metalcore 1
Secret Band	metalcore 1
Secrets	metalcore 2
Seeb	edm 1
Seekae	indietronica
Seers	indie 2
Seether	rock
Sefa	hardstyle
Seinabo Sey	pop 1
Selahattin Özdemir	alternative metal
Selena Gomez	pop 2
Selena Gomez & The Scene	rock
Semisonic	politically engaged
Sep-87	indietronica
Sepharina	edm 1
Sepultura	alternative metal
Serengeti	rock
Serge Gainsbourg	indie 2
Sergei Prokofiev	rock
Sergei Rachmaninoff	rock
Sergio Dalma	pop-punk 1
Serj Tankian	rock
Set Fire To Flames	electronica
Seth Sentry	internet culture
Seu Jorge	indie 1
Sevdaliza	pop 2
Seven Lions	edm 2
Seventh Wonder	power metal
Sex Pistols	pop-punk 1
Shabazz Palaces	rap 1
Shad	rap 1
Shade Empire	doom metal
Shades	edm 2
Shadow of Intent	progressive metal 2
Shahmen	rap 1
Shakewell	rap 1
Shakey Graves	indie 1
Shakira	rock
Shallou	edm 2
Shame	indie 3
Shamir	pop 1
Shania Twain	internet culture 2
Shannon Green	indietronica
Shapist	metalcore 2
Sharon Jones & The Dap-Kings	indie 1
Sharon Van Etten	indie 2
Shatter	indietronica
Shawn Bibb	internet culture
Shawn James	video game music
Shawn Mendes	pop 2
Shawn Sleeps Naked	spotify
Shawn Wasabi	indietronica
Shea Couleé	RuPaul
Shearwater	indie 3
Sheck Wes	rap 1
Sheena Ringo	J-pop
Sheep, Dog & Wolf	indie 2
Sheer Mag	indie 3
Shel Silverstein	internet culture
Shi-Fi	music makers 1
ShiBoy	synthwave
Shigeru Umebayashi	soundtrack
Shigeto	indietronica
Shihad	indie 1
Shinedown	rock
Shining	alternative metal
Shinyribs	video game music
Shirley Ellis	internet culture
Shiro Sagisu	otacore
Shirt	rap 2
Shlohmo	indietronica
Shocking Blue	rock
Shokk	internet culture 2
Shoko Nakagawa	otacore
Shokran	progressive metal 2
Shook	electronica
Shoreline Mafia	despacito
Show Me the Body	psychedelic rock
Showbiz & A.G.	internet culture
Showtek	hardstyle
Shpongle	indietronica
Shredders	rap 1
Shrezzers	metalcore 2
Shrinebuilder	doom metal
Shuggie Otis	jazz
Shura	pop 1
SiR	rap 3
Sia	rock
Siakol	Europe
Sianvar	metalcore 1
Sibylle Baier	indie 1
Sick Animation	rock
Sick Individuals	edm 2
Sigala	edm 1
Sigh	doom metal
Sigrid	pop 2
Sigur Rós	indie 1
SikTh	progressive metal
Silent Planet	metalcore 2
Silk Animus	rap 3
Silk City	edm 1
Silver Mt. Zion	psychedelic rock
Silverchair	indie 1
Silverstein	metalcore 1
Silversun Pickups	indie 1
Simian Mobile Disco	electronica
Simon & Garfunkel	internet culture 2
Simon Alexander	music makers 1
Simon Patterson	edm 1
Simon Viklund	video game music
Simple Citizens	rap 2
Simple Minds	internet culture
Simple Plan	internet culture 2
Simply Red	rock
Sincere Engineer	emo
Sing Street	soundtrack
Sinoia Caves	synthwave
Sinéad O'Connor	rock
Sion	soundtrack
Siouxsie and the Banshees	psychedelic rock
Sir Michael Rocks	pop 1
Sir Mix-A-Lot	internet culture
Sir Sly	indie 1
Sir Spyro	grime
Sirenia	power metal
Sirens And Sailors	metalcore 2
Siriusmo	electronica
Sister Nancy	rap 2
Six Missing	Europe
Sixx:A.M.	indie 1
Sjowgren	indie 2
Skating Polly	indie 2
Skee Mask	electronica
Skeletonwitch	doom metal
Skepta	rap 1
Skeptics	Europe
Ski Mask The Slump God	rap 3
Skillet	internet culture 2
Skinny Puppy	synthwave
Skinshape	psychedelic rock
Skream	edm 1
Skrillex	indietronica
Skunk Anansie	politically engaged
Sky Ferreira	pop 1
Skyharbor	progressive metal
Skyhill	internet culture 2
Skylar Grey	pop 1
Skylar Spence	electronica
Skywave	indie 3
Skálmöld	rock
Slagsmålsklubben	internet culture
Slaughter Beach, Dog	emo
Slaughter to Prevail	progressive metal 2
Slaves	pop-punk 1
Slayer	rock
Sleater-Kinney	indie 2
Sleep	alternative metal
Sleep Token	alternative metal
Sleeping At Last	rock
Sleeping With Sirens	metalcore 1
Sleepy Crow	synthwave
Sleepytime Gorilla Museum	alternative metal
Sleigh Bells	indie 1
Slice The Cake	progressive metal 2
Slick Rick	rap 2
Slightly Stoopid	indietronica
Slim Thug	rap 3
Slint	indie 2
Slipknot	rock
Slippy	monstercat
Sloan	indie 1
Sloppy Seconds	pop-punk 1
Slothrust	indie 3
Slow Club	indie 1
Slow Corpse	indie 2
Slow Magic	edm 1
Slowdive	indie 2
Slugabed	indietronica
Slum Village	rap 3
Slushii	edm 2
Sly & The Family Stone	rock
Small Faces	indie 1
Small Town Titans	indie 1
Smallpools	indie 1
Smash Mouth	internet culture 2
Smif-N-Wessun	rap 3
Smino	rap 3
Smog	indie 1
Smokepurpp	rap 3
Smokey Robinson & The Miracles	rock
Snail Mail	indie 3
Snail's House	internet culture 2
Snails	edm 2
Snak The Ripper	indietronica
Snakehips	edm 1
Snarky Puppy	jazz
Snavs	monstercat
Sneaker Pimps	rock
Sneaky Sound System	pop 1
Snog	synthwave
Snoop Dogg	rap 1
Snow Patrol	rock
So Called People	music makers 1
SoMo	indie 1
Soap&Skin	indie 1
Soccer Mommy	indie 3
Social Distortion	rock
Social Norms	indie 3
Soda Stereo	Europe
Soen	progressive metal
Sofi Tukker	pop 1
Soft Hair	psychedelic rock
"Soil & ""Pimp"" Sessions"	jazz
Soilwork	doom metal
Soko	indie 1
Sol	rap 1
Sol Seppy	indie 1
Solange	pop 1
Solar Fields	indietronica
Solarstone	trance
Sole	rap 3
Solillaquists of Sound	rap 2
Something Corporate	pop-punk 1
Son Little	indie 2
Son Lux	indie 3
SonReal	rap 2
Sonata Arctica	alternative metal
Sonder	rap 3
Songhoy Blues	indie 2
Songs: Ohia	indie 1
Sonic Youth	psychedelic rock
Sonny Rollins	jazz
Sons Of Kemet	jazz
Sophie Zelmani	rock
Sorority Noise	emo
Sorrow	indietronica
Sortilège	doom metal
Soul Asylum	pop 1
Soulive	jazz
Soulja Boy	rap 2
Souls Of Mischief	rap 1
Soulwax	electronica
Soundgarden	rock
Southern Culture on the Skids	internet culture
Space Laces	edm 2
SpaceGhostPurrp	rap 3
Spacehog	indie 1
Spaceslug	psychedelic rock
Spafford	jazz
Spag Heddy	edm 2
Spandau Ballet	rock
Sparkee	edm 1
Sparks	psychedelic rock
Sparrow Sleeps	pop-punk 2
Special Request	electronica
SpectraSoul	DnB
Speedy Ortiz	indie 2
Spellling	rock
Spencer Brown	trance
Spice Girls	rock
Spiderbait	internet culture
Spiller	indietronica
Spin Doctors	rock
Spindrift	psychedelic rock
Spinvis	Europe
Spirit Zoo	indie 2
Spiritualized	indie 2
Split Enz	rock
Spongebob Squarepants	internet culture
Spooky Black	rap 1
Spoon	indie 2
Spoonbill	indie 1
Spor	DnB
Spose	rap 1
Sqrtofneg1	music makers 1
Squarepusher	electronica
Squirrel Nut Zippers	rock
Ssion	pop 2
St Germain	electronica
St. Lucia	indie 2
St. Vincent	pop 1
Stabbing Westward	indie 1
Stainless Steele	rap 1
Stam1na	spotify
Stan Bush	internet culture
Stan Getz	indie 1
Stand Atlantic	pop-punk 2
Starbomb	video game music
Starcadian	indietronica
Stark Reality	psychedelic rock
Starlito	rap 2
Stars	indie 1
Stars Of The Lid	electronica
Starsailor	video game music
State Champs	pop-punk 2
Static-P	otacore
Statik Selektah	rap 3
Steam Powered Giraffe	indie 1
Steel Panther	internet culture
Steely Dan	rock
Stefanie Joosten	video game music
Stefflon Don	rap 1
Stellar	K-pop 1
Stellardrone	indietronica
Stephan Bodzin	electronica
Stephanie D'Abruzzo	internet culture
Stephanie Mills	indietronica
Stephen	monstercat
Stephen Colbert	rock
Stephen Sondheim	internet culture 2
Stephen Swartz	indietronica
Stephen Walking	monstercat
Steps	rock
Stereolab	indie 2
Stereophonics	rock
Steve Angello	edm 2
Steve Aoki	edm 1
Steve Harvey	internet culture
Steve Lacy	rap 2
Steve Miller Band	internet culture 2
Steve Reich	jazz
Steven Universe	internet culture 2
Steven Wilson	indie 1
Stevie Ray Vaughan	rock
Stevie Wonder	rock
Stick Figure	indietronica
Stick To Your Guns	metalcore 2
Sticky Fingers	indie 1
Stiff Little Fingers	indie 1
Still Corners	indie 3
Still Woozy	indie 2
Sting	rock
Stompin' Tom Connors	internet culture 2
Stone Temple Pilots	rock
Stonebank	monstercat
Stoned Jesus	psychedelic rock
Stories	metalcore 2
Stormzy	rap 1
Straight Up	indie 1
Stratovarius	power metal
Strawberry Girls	psychedelic rock
Stray Cats	rock
Stray From The Path	politically engaged
Stray Kids	K-pop 2
Street Sects	indie 3
Streetlight Manifesto	indie 1
Stromae	rock
Strong Arm Steady	rap 3
Stuart Chatwood	video game music
Studio Killers	internet culture 2
Stump	rock
Sturgill Simpson	rock
Styles Of Beyond	rap 3
Styx	rock
Sub Focus	DnB
Sub Zero Project	hardstyle
SubRosa	doom metal
Sublime	rock
Submotion Orchestra	indietronica
Subtact	monstercat
Suburban Dream	spotify
Suburban Legends	rock
Subvision	alternative metal
Subway Sect	psychedelic rock
Suchmos	J-pop
Sufjan Stevens	indie 1
Sugababes	internet culture
Sugar	rock
Sugar Candy Mountain	indie 3
Sugar Pine 7	despacito
Sugar Ray	rock
Suicidal Tendencies	internet culture
Suicide	psychedelic rock
Suicide Silence	metalcore 1
Suicideyear	rap 1
Sullivan King	edm 2
Sulphur Aeon	doom metal
Sum 41	pop-punk 1
Summer Heart	indietronica
Summer Like the Season	psychedelic rock
Summer Salt	indie 3
Summer Was Fun	monstercat
Summoning	doom metal
Sun Kil Moon	indie 1
Sun Ra	jazz
Sundara Karma	indie 2
Sunflower Bean	indie 3
Sunn 0)))	alternative metal
Sunna	indie 1
Sunny Day Real Estate	pop-punk 1
Sunny Lax	trance
Sunrey	rap 3
Sunrise Skater Kids	pop-punk 1
Sunset Rollercoaster	indie 2
Super Furry Animals	indie 1
Superchunk	rap 1
Superfly	pop 1
Superfruit	pop 3
Supergrass	indie 1
Supergroove	Europe
Superheaven	rock
Supermode	indietronica
Superorganism	indie 3
Supertramp	rock
Sure Matt Sure	music makers 1
Sure Sure	indie 2
Surf Curse	indie 3
Surfer Blood	indie 2
Survivor	internet culture
Susanne Sundfør	pop 1
Suuns	indie 3
Suzanne Vega	rock
Svi na pod	rap 2
Swallow The Sun	doom metal
Swanky	rock
Swans	indie 2
Swearr	indietronica
Swedish House Mafia	indietronica
Sweet Jonny	pop-punk 1
Sweet Trip	psychedelic rock
Sweet Valley	indietronica
Swet Shop Boys	rap 1
Swiss Lips	indie 1
Switchfoot	rock
Swizz Beatz	rap 3
Sybyr	rap 3
Sycamore	politically engaged
Syd	rap 1
Syd Barrett	rock
Syd Matters	internet culture 2
Sylar	metalcore 1
Sylosis	doom metal
Sylvan Esso	indietronica
Sylvan LaCue	rap 3
Sylvania Ave.	pop-punk 2
Symere Woods	rap 3
Symphony X	alternative metal
System Of A Down	rock
Szymon	indie 2
Sébastien Tellier	internet culture
Sólstafir	rock
T-Pain	rap 1
T-ara	K-pop 1
T. Rex	rock
T.I.	rap 1
T.J. Miller	rock
TACONAFIDE	Europe
TAEMIN	K-pop 2
TAEYANG	K-pop 1
TAEYEON	K-pop 1
TAI	monstercat
TENDER	indie 2
TG Lurgan	psychedelic rock
THEY.	rap 1
TIL ALL IS ONE	rap 3
TK from Ling tosite sigure	otacore
TLC	rock
TNGHT	rap 1
TOBACCO	indietronica
TOKiMONSTA	rap 1
TOLEDO	Europe
TOOL	rock
TOPS	indie 3
TORRES	indie 3
TOTO	internet culture 2
TOUCAN	music makers 1
TTNG	internet culture 2
TV Girl	indie 2
TV On The Radio	indie 1
TVDS	monstercat
TVXQ!	K-pop 2
TWICE	K-pop 1
TWRP	internet culture 2
TYNAN	edm 2
Ta-ku	indietronica
Tacocat	indie 1
Tag Team	rock
Takeoff	rap 3
Taking Back Sunday	pop-punk 1
Takuya Kuroda	jazz
Tal Bachman	rock
Talib Kweli	rap 3
Talk Talk	indie 2
Talking Heads	rock
Tamaryn	psychedelic rock
Tame Impala	indie 1
Tamino	indie 2
TandMProductionCo	edm 1
Tangerine Dream	indietronica
Tank and The Bangas	rap 2
Tankard	doom metal
Tantric	politically engaged
Tanukichan	indie 3
Tanya Tagaq	indie 2
Tash Sultana	indie 1
Taska Black	edm 2
Tauk	indie 1
Tay-K	rap 3
Taylor Bennett	rap 3
Taylor J	spotify
Taylor McFerrin	indietronica
Taylor Swift	pop 1
Taylored	spotify
Tchami	edm 2
Team Dresch	pop-punk 1
Tears For Fears	rock
Tech N9ne	rap 1
Tech N9ne Collabos	rap 2
Technimatic	DnB
TeddyLoid	J-pop
Tedeschi Trucks Band	indie 1
Tee Grizzley	rap 3
Teen Suicide	indie 3
Teenage Bottlerocket	pop-punk 1
Teenage Wrist	indie 3
Tegan and Sara	internet culture 2
Tei Shi	pop 1
Telefon Tel Aviv	indietronica
Television	indie 1
Televisor	monstercat
Tellurian	psychedelic rock
Teminite	monstercat
Temples	psychedelic rock
Ten Walls	electronica
Tenacious D	internet culture
Tengger Cavalry	alternative metal
Tennessee Ernie Ford	rock
Tennis	indie 2
Tennyson	edm 1
Teo	rap 3
Teriyaki Boyz	internet culture 2
Terrace Martin	rap 3
TerribleTim	internet culture 2
Terror Jr	pop 2
Teräsbetoni	alternative metal
Tesla	rock
Tessa Violet	pop 1
TesseracT	progressive metal
Testament	doom metal
Textures	progressive metal
Teyana Taylor	rap 3
Thaiboy Digital	rap 4
Thane	despacito
Thank You Scientist	alternative metal
Thanks, Computer!	internet culture
Thankyou	rap 3
Thao & The Get Down Stay Down	indie 2
That Poppy	rock
The (International) Noise Conspiracy	rock
The 13th Floor Elevators	psychedelic rock
The 1975	pop 1
The 6ths	indie 2
The 88	soundtrack
The Acacia Strain	progressive metal 2
The Academic	indie 1
The Aces	pop 2
The Acid	indietronica
The Adventures of Duane & Brando	video game music
The Afterimage	metalcore 2
The Airborne Toxic Event	indie 1
The Alan Parsons Project	rock
The Album Leaf	indie 1
The Alchemist	rap 3
The Algorithm	alternative metal
The All-American Rejects	rock
The Allman Brothers Band	rock
The Amity Affliction	metalcore 1
The Andrews Sisters	internet culture
The Animals	rock
The Antlers	indie 1
The Apples In Stereo	indie 1
The Appleseed Cast	pop-punk 1
The Aquabats!	rock
The Archies	rock
The Arcs	indie 2
The Armed	metalcore 1
The Art Of Noise	rock
The Association	rock
The Asteroids Galaxy Tour	indie 1
The Avalanches	rock
The Avett Brothers	indie 1
The B-52's	internet culture 2
The Background Musicians	internet culture 2
The Bad Plus	jazz
The Bangles	rock
The Barren Gods	psychedelic rock
The Beach Boys	rock
The Beaches	indie 2
The Beards	internet culture
The Beatles	rock
The Beautiful South	internet culture
The Beta Band	psychedelic rock
The Beths	indie 3
The Big Moon	indie 3
The Black Angels	indie 1
The Black Dahlia Murder	doom metal
The Black Dog	electronica
The Black Keys	rock
The Black Piper	video game music
The Black Queen	indietronica
The Blasting Company	internet culture 2
The Blaze	indietronica
The Bloody Beetroots	edm 1
The Blow	indie 1
The Body	doom metal
The Bombay Royale	soundtrack
The Books	indietronica
The Boy Least Likely To	indie 1
The Brand New Heavies	jazz
The Brass	rap 1
The Bravery	rock
The Breathing Effect	indie 2
The Breeders	rock
The Brian Jonestown Massacre	psychedelic rock
The Bright Light Social Hour	indie 2
The Brobecks	indie 1
The Brotet	internet culture 2
The Browning	metalcore 1
The Budos Band	jazz
The Bug	electronica
The Buggles	rock
The Bunny Tylers	indie 3
The Buttertones	indie 3
The Calling	rock
The Calm Blue Sea	psychedelic rock
The Cardigans	rock
The Cars	rock
The Carters	rap 1
The Cat Empire	indie 1
The Chain Gang Of 1974	indie 1
The Chainsmokers	edm 1
The Chameleons	psychedelic rock
The Champs	rock
The Chemical Brothers	indietronica
The Chieftains	rock
The Chiffons	rock
The Children Of Sunshine	internet culture 2
The Chills	indie 2
The Chordettes	internet culture 2
The Cinematic Orchestra	indie 1
The Civil Wars	rock
The Clash	internet culture 2
The Classless	indie 3
The Claypool Lennon Delirium	psychedelic rock
The Clientele	pop 1
The Coasters	internet culture
The Collapsable Hearts Club	internet culture
The Colourist	rock
The Contortionist	progressive metal
The Cool Kids	rap 1
The Coral	indie 1
The Correspondents	indietronica
The Coup	politically engaged
The Crack	indie 1
The Cramps	indie 1
The Cranberries	rock
The Crimson Armada	metalcore 2
The Crystal Method	indietronica
The Cult	rock
The Cure	rock
The Dali Thundering Concept	metalcore 2
The Darkness	rock
The Dave Brubeck Quartet	jazz
The Dead South	rock
The Dead Weather	indie 1
The Dear Hunter	indie 1
The Decemberists	indie 1
The Derevolutions	indie 2
The Devil Makes Three	indie 1
The Devil Wears Prada	metalcore 2
The Dillinger Escape Plan	alternative metal
The Diplomats	rap 3
The Dirty Nil	indie 2
The Districts	indie 2
The Divine Comedy	indie 1
The Dodos	indie 3
The Donkeys	indie 1
The Doobie Brothers	indietronica
The Doors	rock
The Draymin	rock
The Dreadnoughts	video game music
The Dream Academy	rock
The Drones	indie 2
The Drums	indie 2
The Dubliners	internet culture
The Early November	pop-punk 1
The Easybeats	indie 1
The Echo Within	music makers 1
The Encounter	rap 1
The Evil Exes	soundtrack
The Evpatoria Report	psychedelic rock
The Exploited	rap 1
The Extra Glenns	indie 2
The Faceless	doom metal
The Fall	psychedelic rock
The Fall of Troy	pop-punk 1
The Family Crest	psychedelic rock
The Fearless Flyers	jazz
The Feelies	psychedelic rock
The Field	electronica
The Field Mice	indie 3
The Fiery Furnaces	indie 2
The Five Stairsteps	rock
The Flaming Lips	indie 1
The Flatliners	pop-punk 1
The Floodshark	indie 2
The Foreign Exchange	rap 3
The Format	indie 1
The Four Lads	internet culture
The Four Owls	rap 1
The Fratellis	internet culture 2
The Fray	internet culture
The Frights	indie 2
The Front Bottoms	pop-punk 1
The Fugs	rock
The Future Sound Of London	electronica
The GOASTT (The Ghost Of A Saber Tooth Tiger)	psychedelic rock
The Game	rap 1
The Gap Band	rock
The Gaslight Anthem	indie 1
The Gay Brownie Boys	psychedelic rock
The Get Up Kids	pop-punk 1
The Ghost Inside	metalcore 1
The Glitch Mob	indietronica
The Gloom In The Corner	metalcore 2
The Glorious Sons	rock
The Go! Team	indie 2
The Go-Betweens	psychedelic rock
The Goo Goo Dolls	rock
The Good Life	rap 1
The Good, the Bad & the Queen	indie 2
The Greeting Committee	indie 3
The Gregory Brothers	internet culture
The Griswolds	indietronica
The Grizzly Folk	psychedelic rock
The Growlers	indie 2
The Gun Club	pop-punk 1
The HU	internet culture 2
The Handsome Family	rock
The Hat	soundtrack
The Haxan Cloak	pop-punk 1
The Head and the Heart	indie 1
The Heavy	rock
The Helix Nebula	progressive metal
The Hillbilly Moon Explosion	indie 1
The Him	edm 2
The Hives	rock
The Hold Steady	indie 1
The Hollies	rock
The Holydrug Couple	indie 3
The Horrors	indie 3
The Hotelier	emo
The Housemartins	indie 1
The Human Abstract	progressive metal
The I.L.Y's	electronica
The Instant Classic	indie 1
The Internet	rap 1
The Interrupters	pop-punk 1
The Irish Rovers	rock
The Isley Brothers	rock
The Jackson 5	rock
The Jacksons	pop 1
The Jam	rock
The Japanese House	pop 1
The Jesus Lizard	pop-punk 1
The Jesus and Mary Chain	psychedelic rock
The Jim Carroll Band	indie 1
The Joy Formidable	indie 1
The Killers	rock
The Kills	indie 1
The King Khan & BBQ Show	indie 1
The Kinks	rock
The Knack	rock
The Knife	indie 1
The Knocks	pop 1
The Kooks	indie 1
The Langley Schools Music Project	rock
The Last Shadow Puppets	indie 1
The Lawrence Arms	pop-punk 1
The Lemon Twigs	indie 3
The Lemonheads	rock
The Libertines	indie 1
The Limousines	internet culture
The Living End	rock
The Living Tombstone	internet culture 2
The London Film Score Orchestra	rock
The Lonely Island	internet culture
The Long Winters	indie 1
The Lord Weird Slough Feg	doom metal
The Lowbrow	progressive metal
The Lumineers	rock
The M Machine	edm 1
The Maccabees	indie 1
The MaddGeek	lo-fi
The Magician	indietronica
The Magnetic Fields	indie 1
The Maine	pop-punk 1
The Mamas & The Papas	rock
The Marcus King Band	indie 1
The Mars Volta	indie 1
The Marvelettes	rock
The Marías	pop 1
The Masons	rap 3
The Maytals	rock
The Megas	video game music
The Menzingers	pop-punk 1
The Merry Macs	indietronica
The Meters	rock
The Microphones	indie 2
The Middle East	indie 1
The Midnight	indietronica
The Mighty Mighty Bosstones	internet culture 2
The Milk Carton Kids	indie 1
The Modern Lovers	psychedelic rock
The Moldy Peaches	rock
The Monkees	rock
The Morning Benders	indie 1
The Moth & The Flame	rap 2
The Mountain Goats	rock
The Mowgli's	indie 1
The Murlocs	indie 3
The Naked And Famous	indie 1
The National	soundtrack
The Neighbourhood	rock
The New Age	metalcore 2
The New Pornographers	indie 2
The Notorious B.I.G.	rap 1
The O'Jays	internet culture 2
The Ocean	progressive metal
The Offspring	rock
The Oh Hellos	indie 1
The Olivia Tremor Control	psychedelic rock
The Ongoing Concept	metalcore 1
The Only Ones	pop-punk 1
The Opposites	edm 1
The Orb	edm 1
The Organ	psychedelic rock
The Orphans	pop-punk 1
The Orwells	indie 2
The Outfield	politically engaged
The Paper Chase	indie 1
The Paper Kites	indie 1
The Pharcyde	rap 1
The Physics House Band	psychedelic rock
The Piano Guys	rock
The Pineapple Thief	progressive metal
The Platters	indietronica
The Plot In You	metalcore 2
The Pogues	rock
The Pointer Sisters	internet culture 2
The Police	rock
The Postal Service	indie 1
The Presets	indie 1
The Presidents Of The United States Of America	rock
The Pretty Reckless	internet culture
The Prize Fighter Inferno	indie 1
The Proclaimers	internet culture
The Prodigy	indietronica
The Protomen	internet culture
The Psychedelic Furs	indie 1
The Pussycat Dolls	rock
The Qemists	DnB
The Queers	pop-punk 1
The Raconteurs	indie 1
The Radio Dept.	indie 3
The Raincoats	indie 2
The Range	psychedelic rock
The Rasmus	Europe
The Raveonettes	psychedelic rock
The Real McKenzies	rock
The Red Army Choir	internet culture 2
The Red Jumpsuit Apparatus	rock
The Refreshments	rock
The Regrettes	pop 1
The Reign of Kindo	indie 1
The Rentals	rock
The Replacements	indie 1
The Residents	indie 1
The Return	indie 1
The Revels	internet culture 2
The Revivalists	rock
The Righteous Brothers	rock
The Rolling Stones	rock
The Romantics	rock
The Ronettes	pop 1
The Roots	rap 1
The Rubens	indie 2
The Rural Alberta Advantage	indie 2
The Saboteurs	indie 1
The Samples	indietronica
The Score	internet culture 2
The Script	rock
The Shanghai Restoration Project	indietronica
The Shapeshifters	indietronica
The Shins	indie 1
The Simpsons	rock
The Smashing Pumpkins	indie 1
The Smith Street Band	indie 3
The Smiths	rock
The Sneepers	soundtrack
The So So Glos	rock
The Soft Moon	pop-punk 1
The Sound	psychedelic rock
The Sound of Arrows	pop 1
The Sounds	rock
The Specials	rock
The Spill Canvas	rock
The Spinners	rock
The Spook School	indie 1
The Starting Line	pop-punk 2
The Staves	indie 2
The Stone Roses	indie 1
The Stooges	pop-punk 1
The Story So Far	pop-punk 2
The Stranglers	rock
The Streets	rap 2
The Strokes	indie 1
The Strumbellas	rock
The Struts	indie 1
The Sugarcanes	indie 2
The Sugarcubes	psychedelic rock
The Suicide Machines	rock
The Sundays	indie 1
The Supremes	rock
The Sword	alternative metal
The Tallest Man On Earth	indie 2
The Taxpayers	pop-punk 1
The Temper Trap	indie 1
The Temptations	indie 1
The The	indie 1
The Thermals	indie 1
The Ting Tings	internet culture
The Tokens	internet culture 2
The Tony Danza Tapdance Extravaganza	alternative metal
The Top Stoppers	internet culture
The Toxic Avenger	indietronica
The Tragically Hip	rock
The Twilight Sad	psychedelic rock
The Uncluded	rap 2
The Underachievers	rap 3
The Undertones	indie 1
The Unicorns	indie 2
The United States Of America	psychedelic rock
The Upbeats	DnB
The Used	pop-punk 1
The Vaccines	indie 2
The Vapors	internet culture 2
The Veils	indie 2
The Velvet Underground	rock
The Venetia Fair	metalcore 1
The Verve	rock
The Very Best	indietronica
The Voidz	indie 3
The Walkmen	indie 1
The Wallflowers	indie 1
The Wannadies	internet culture
The War On Drugs	indie 2
The Weakerthans	indie 1
The Weather Girls	internet culture
The Weeknd	rap 1
The Weepies	indie 1
The White Buffalo	indie 1
The White Mandingos	rap 2
The White Noise	metalcore 1
The White Stripes	rock
The Whitest Boy Alive	indie 1
The Who	rock
The Wiggles	internet culture 2
The Winstons	indietronica
The Wolf Rock Band	spotify
The Wolves of Chernobyl	psychedelic rock
The Wombats	indie 1
The Wonder Years	pop-punk 2
The Word Alive	metalcore 2
The World Is A Beautiful Place & I Am No Longer Afraid To Die	indie 3
The Wrens	indie 2
The Wurzels	internet culture
The Yardbirds	rock
The Yellow River Boys	rock
The Yogscast	internet culture 2
The Zolas	indie 2
The Zombies	rock
The Zutons	indie 1
The xx	indie 1
The-Dream	rap 1
TheFatRat	monstercat
Thedeus White	indie 1
Thee Minks	pop-punk 1
Thee Oh Sees	psychedelic rock
Thelonious Monk	jazz
Them Crooked Vultures	indie 1
Theo Katzman	jazz
Theophilus London	rap 1
Theory of a Deadman	rock
Therein	internet culture 2
They Might Be Giants	rock
Thievery Corporation	indietronica
Thieves Like Us	indietronica
Thin Lizzy	internet culture 2
Third Eye Blind	rock
Third Party	edm 2
Thirty Seconds To Mars	rock
This Mortal Coil	indie 1
This Will Destroy You	psychedelic rock
Thom Yorke	indie 2
Thomas Bergersen	internet culture
Thomas Dolby	rock
Thomas Happ	video game music
Thomas Newman	soundtrack
Thomas Oliver	internet culture
Thomas Rhett	pop 2
Thomas Tallis	rock
Thomston	pop 3
Thornhill	metalcore 2
Thou	doom metal
Thousand Below	metalcore 2
Thousand Foot Krutch	rock
Thouxanbanfauni	rap 3
Three 6 Mafia	rap 3
Three Days Grace	internet culture 2
Three Dog Night	internet culture 2
Three Trapped Tigers	psychedelic rock
Thrice	pop-punk 1
Throttle	edm 2
Throwing Muses	psychedelic rock
Thundercat	indietronica
Thunderclap Newman	rock
Thursday	metalcore 1
Thutmose	rap 3
Thy Art Is Murder	metalcore 1
Thy Catafalque	doom metal
Tiago Bettencourt	electronica
Tides From Nebula	psychedelic rock
Tides Of Man	psychedelic rock
Tiffany Young	K-pop 2
Tiga	indietronica
Tigers Jaw	pop-punk 2
Tilian	metalcore 1
Tim Berg	edm 1
Tim Buckley	indie 1
Tim Hecker	electronica
Tim Heidecker	politically engaged
Tim Minchin	internet culture
Timbaland	rock
Timber Timbre	indie 2
Time, The Valuator	progressive metal 2
Timecop1983	synthwave
Timeflies	pop 3
Times Of Grace	metalcore 1
Timmy Trumpet	edm 2
Timothy	music makers 1
Tina Guo	video game music
Tina Turner	internet culture 2
Tinariwen	indie 1
Tinashe	pop 3
Tino Rondz	indie 2
Tiny Hueman	indie 1
Tiny Meat Gang	rap 3
Tiny Moving Parts	emo
Tiny Tim	internet culture
Tipper	indietronica
Title Fight	pop-punk 1
Titus Andronicus	indie 2
Tiësto	edm 1
Tobe Nwigwe	rap 2
Tobu	monstercat
Toby Fox	video game music
Tocotronic	Europe
Todd Glass	internet culture
Todd Snider	rock
Todd Terje	indietronica
Toh Kay	indie 1
Token	rap 1
Tokio Hotel	rock
Tokoyo	indietronica
Tokyo Machine	monstercat
Tokyo Police Club	indie 3
Tom Cochrane	rock
Tom Day	indie 1
Tom Misch	indietronica
Tom Morello	metalcore 1
Tom Morello: the Nightwatchman	rock
Tom Odell	indie 1
Tom Petty	rock
Tom Petty and the Heartbreakers	rock
Tom Rosenthal	indie 3
Tom Scott	rap 2
Tom Waits	rock
Tomahawk	rock
Tomer	music makers 1
Tommy Cash	rap 2
Tommy Emmanuel	indie 1
Tommy Genesis	rap 3
Tommy Jesus	psychedelic rock
Tommy Safespace and The Libtards	rock
Tomppabeats	indietronica
Tomáš Dvořák	video game music
Tones And I	despacito
Tonetta	internet culture
Tongues of Fire	emo
Tonic	indie 1
Tonight Alive	pop-punk 1
Tony Paone	lo-fi
Too $hort	rap 2
Too Close To Touch	metalcore 1
Too Many Zooz	indietronica
Toots & The Maytals	rock
Topaz Jones	rap 3
Topi	monstercat
Tor	indietronica
Torche	alternative metal
Tori Kelly	pop 2
Toro y Moi	indietronica
Tortoise	psychedelic rock
Tory Lanez	rap 3
Totally Enormous Extinct Dinosaurs	edm 1
Totorro	psychedelic rock
Touch Sensitive	electronica
Touché Amoré	emo
Toumani Diabaté's Symmetric Orchestra	indie 1
Toundra	psychedelic rock
Tourist	edm 1
Tove Lo	rock
Tove Styrke	pop 2
Tower Of Power	jazz
Townes Van Zandt	indie 1
Tracey Ullman	rock
Tracy Chapman	rock
Traditional	rock
Trae Tha Truth	rap 3
Traffic	indie 1
Train	rock
Trampled by Turtles	indie 1
Trapped Under Ice	metalcore 1
Trash Boat	pop-punk 2
Traveler	emo
Traveling Wilburys	indie 1
Travie McCoy	rock
Travis	rock
Travis Bretzer	indie 2
Travis Scott	rap 3
Trazan & Banarne	indietronica
Tremonti	alternative metal
Trent Reznor and Atticus Ross	indie 1
Trepalium	doom metal
Trevor Jones	indie 1
Trevor Kowalski	music makers 1
Trevor Moore	internet culture
Trevor Morris	video game music
Trevor Something	synthwave
Trey Parker	internet culture
Trick Trick	politically engaged
Tricky	psychedelic rock
Trifonic	indietronica
Trio	rock
Triosphere	power metal
Triple One	rap 1
Trippie Redd	rap 3
Trippy Ja	music makers 1
Triptykon	doom metal
Tristam	monstercat
Tritonal	edm 2
Trivecta	monstercat
Trivium	metalcore 1
Trixie Mattel	RuPaul
Trophy Eyes	pop-punk 2
Trophy Scars	pop-punk 1
Tropical Fuck Storm	indie 3
Tropical Storm	internet culture
Trouble	doom metal
Trouble Maker	K-pop 1
Troy Bruce	internet culture
TroyBoi	edm 2
Troye Sivan	pop 2
Truckfighters	alternative metal
True Widow	psychedelic rock
Tub Ring	indie 1
Tune-Yards	indie 2
Tunng	indie 2
Tuomas Holopainen	alternative metal
Turbonegro	indie 1
Turisas	alternative metal
Turmion Kätilöt	spotify
Turnover	pop-punk 1
Turnpike Troubadours	rock
Turnstile	metalcore 1
Tut Tut Child	monstercat
Twelve Foot Ninja	alternative metal
Twenty One Pilots	rock
Twilight Force	power metal
Twin Peaks	indie 3
Twin Shadow	indie 1
Twinkle Twinkle Little Rock Star	K-pop 1
Twinsmith	psychedelic rock
Twista	rap 1
Two Door Cinema Club	indie 1
Two Feet	indietronica
Two Gallants	indie 1
Two Hours Traffic	Europe
Two Legs	doom metal
Two Steps from Hell	internet culture 2
Ty Dolla $ign	rap 3
Ty Segall	indie 3
Ty Segall Band	psychedelic rock
Tycho	indietronica
Tyga	rap 1
Tyler Bates	soundtrack
Tyler Childers	indie 1
Tyler Ward	soundtrack
Tyler, The Creator	rap 1
Type O Negative	rock
Typhoon	indie 2
Tyree D.	music makers 1
Télépopmusik	indietronica
Týr	alternative metal
U.S. Girls	indie 3
U2	rock
UGK	rap 1
UGLYFRANK	rap 3
UNKLE	indie 1
UZ	edm 2
Ugly God	rap 1
Ugly Kid Joe	rock
Ulrich Schnauss	indietronica
Ultrasound Express	psychedelic rock
Ultravox	rock
Ulver	alternative metal
Um Corpo Estranho	psychedelic rock
Ummet Ozcan	edm 2
Umphrey's McGee	indie 1
Uncle Acid & The Deadbeats	alternative metal
Underoath	metalcore 1
Underworld	indietronica
Unicorn Kid	edm 1
Unito	electronica
Unknown Mortal Orchestra	indie 2
Unleash The Archers	alternative metal
Unlike Pluto	monstercat
Unlucky Morpheus	power metal
UnoTheActivist	rap 1
Unwound	indie 3
Up Dharma Down	Philippines
Upon A Burning Body	rock
Uppermost	indietronica
Ursa the Chef	spotify
Us	indie 1
Us3	rock
Usher	pop 1
Utada	internet culture 2
Utah Phillips	politically engaged
Uyama Hiroto	indietronica
VHS Dreams	synthwave
VIXX	K-pop 2
VOLA	progressive metal
VTA	rap 1
Vaela	metalcore 2
Valdemar	music makers 1
Valentino Khan	indietronica
Vallis Alps	pop 1
Valve Studio Orchestra	video game music
Vampire Weekend	rock
Van Canto	rock
Van Halen	rock
Van Morrison	rock
Vance Joy	rock
Vancouver Sleep Clinic	indie 3
Vanessa Carlton	internet culture
Vanessa Hudgens	pop 2
Vangelis	indietronica
Vanilla	indietronica
Vanna	metalcore 2
Varials	metalcore 2
Varien	monstercat
Varsity	pop 1
Vast	indie 1
Veil Of Maya	progressive metal 2
Vein	metalcore 2
Vektor	doom metal
Velvet Revolver	rock
Vendredi sur Mer	Europe
Venetian Snares	indietronica
Veorra	edm 1
Vera Blue	pop 1
Vercery	indie 1
Vexare	edm 1
Viagra Boys	indie 3
Vic Chesnutt	indie 1
Vic Mensa	rap 1
Vicetone	edm 2
Victor Oladipo	politically engaged
Video Game Players	internet culture 2
Video Games Live	video game music
Vienna Teng	indie 1
View	indietronica
Views	rock
Viktor Vaughn	rap 3
Vildhjarta	progressive metal
Villagers	indie 2
Vince Guaraldi Trio	jazz
Vince Staples	rap 1
Vincent	edm 2
Vindata	edm 2
Vinyl Theatre	indie 2
Vinyl Williams	psychedelic rock
Vin¢	lo-fi
Vio-Lence	doom metal
Viola Beach	indie 1
Violent Femmes	rock
Violent Soho	indie 1
Violet	music makers 1
Violet Chachki	RuPaul
Viper	rap 2
Virtual Riot	edm 2
Virtual Self	edm 1
Vishal Dadlani	internet culture 2
Visible Cloaks	electronica
Vitalic	indietronica
Vitalism	alternative metal
Vitamin String Quartet	indie 1
Vitas	internet culture
Viviane	psychedelic rock
Vivid Shade	electronica
Vladimir Cauchemar	internet culture
Voivod	doom metal
Volbeat	rock
Volcano Choir	indie 2
Volumes	progressive metal 2
Voyager	progressive metal
Vulfpeck	jazz
Vundabar	indie 3
VÉRITÉ	pop 3
W&W	edm 2
WALK THE MOON	rock
WAVEDASH	edm 2
WEDNESDAY CAMPANELLA	J-pop
WHY?	indietronica
WINNER	K-pop 2
WJSN	K-pop 2
WONK	rock
WRLD	monstercat
WSTR	pop-punk 2
WU LYF	psychedelic rock
WWE	internet culture 2
WagakkiBand	J-pop
Wage War	metalcore 2
Wagon Christ	electronica
Waka Flocka Flame	rap 1
Wale	rap 3
Walk Off the Earth	rock
Wallows	pop 1
Walter TV	psychedelic rock
Wand	psychedelic rock
Wang Chung	soundtrack
Wankelmut	electronica
Wanna One	K-pop 2
War	rock
Wardruna	Europe
Warface	hardstyle
Warhorse	doom metal
Warpaint	rock
Warren G	rap 2
Warren Zevon	rock
Washed Out	indietronica
Wasted Penguinz	hardstyle
Waterflame	internet culture
Waterparks	pop-punk 2
Watsky	rap 2
Wave Racer	edm 1
Wave Saver	rock
Waveshaper	synthwave
Wavves	indie 2
Wax	rap 2
Waxahatchee	indie 3
Waylon Jennings	rock
Wayne Graham	internet culture
Wayne Shorter	jazz
We Are All Astronauts	indietronica
We Are Scientists	indie 3
We Came As Romans	metalcore 2
We Lost The Sea	psychedelic rock
We Love	metalcore 1
We The Kings	internet culture 2
We Were Promised Jetpacks	indie 1
Weather Report	indie 1
Weaver Beats	rap 1
Webbstur	indietronica
Weebl's Stuff	soundtrack
Weekend Players	otacore
Ween	rock
Weezer	rock
Welshly Arms	pop 1
Werner Tautz	internet culture 2
Wes Montgomery	jazz
Wesk	indietronica
Wesley Willis	rock
Westside Gunn	rap 3
Wet	pop 1
Weval	electronica
Weyes Blood	indie 3
Wham!	internet culture 2
What So Not	edm 1
Wheatus	rock
Wheeler Walker Jr.	rock
Whethan	edm 1
While She Sleeps	metalcore 2
Whispered	power metal
White Denim	indie 1
White Lies	indie 1
White Lung	indie 3
White Reaper	indie 3
White Ring	indietronica
White Town	rock
White Zombie	rock
Whitechapel	metalcore 1
Whitesnake	internet culture 2
Whitney	indie 3
Whitney Houston	rock
Whodini	rock
Why Not	music makers 1
Wicca Phase Springs Eternal	rap 4
Wice	synthwave
Wifisfuneral	rap 3
Wiki	rap 3
Wilco	indie 2
Wild Beasts	indie 2
Wild Bill Helium	music makers 1
Wild Cherry	Europe
Wild Nothing	indie 3
Wilderness Survival	indie 2
Wildstylez	hardstyle
Wiley	grime
Wilkinson	edm 1
Will Butler	indie 2
Will Hawkins	indie 2
Will Monahan	emo
Will Smith	rap 1
Willam	RuPaul
William Bell	indietronica
William Elliott Whitmore	video game music
William Fitzsimmons	indietronica
William Joseph & Lindsey Stirling	video game music
William Onyeabor	psychedelic rock
William Shatner	rock
Willie Nelson	rock
Windhand	doom metal
Wing	internet culture
Wings	indie 1
Wintergatan	internet culture
Wintersun	alternative metal
Wipers	pop-punk 1
Wire	pop-punk 1
Wise Guys	Europe
Witch	psychedelic rock
Witchcraft	psychedelic rock
Witchfinder General	doom metal
With Confidence	pop-punk 2
Witherscape	doom metal
Within Temptation	rock
Within The Ruins	progressive metal 2
Witt Lowry	rap 2
Wiwek	edm 2
Wiz Khalifa	rap 3
WizKid	rap 3
WolF6looD	edm 1
Wolf Alice	indie 2
Wolf Parade	indie 1
Wolf People	psychedelic rock
Wolfgang Amadeus Mozart	rock
Wolfgang Gartner	indietronica
Wolfheart	doom metal
Wolfie's Just Fine	internet culture
Wolfmother	indie 1
Wolves At The Gate	metalcore 2
Wolves In The Throne Room	doom metal
Women	indie 3
Wonder Girls	K-pop 1
Woodkid	rock
Woods	indie 3
Woods Of Ypres	alternative metal
Woody Allen	internet culture
Woolbright	internet culture 2
Worakls	edm 1
World Order	internet culture 2
Wrabel	internet culture 2
Wu-Tang Clan	rap 2
Wvs	spotify
Wyatt Cenac	internet culture
Wye Oak	indie 1
X JAPAN	alternative metal
X-Ray Spex	pop-punk 1
XO	rap 3
XTC	rock
XXXTENTACION	rap 1
XYLØ	pop 2
Xan Griffin	edm 2
Xavier Rudd	indietronica
Xavier Wulf	rap 4
Xiu Xiu	indie 2
Xzibit	rap 3
YBN Cordae	rap 3
YBN Nahmir	rap 3
YEAR OF THE OX	rap 2
YELLOW MAGIC ORCHESTRA	indietronica
YENS	internet culture 2
YF JR	internet culture
YG	rap 1
YGTUT	rap 3
YNW Melly	rap 1
YOB	doom metal
YOTA : Youth of the Apocalypse	rap 3
YUNGBLUD	pop 1
YURI (Girls’ Generation)	K-pop 2
Yaeji	pop 1
Yael Naim	rock
Yann	music makers 1
Yann Tiersen	rock
Yanni	pop 2
Yasuharu Takanashi	otacore
Yasutaka Nakata	pop 2
Yazoo	rock
Yeah Yeah Yeahs	indie 1
Years & Years	pop 1
Years Apart	indietronica
Yeasayer	indietronica
Yelawolf	rap 2
Yelle	pop 2
Yello	internet culture
Yellow Claw	edm 1
Yellow Days	indie 3
Yellowcard	pop-punk 1
Yellowman	rap 2
Yes	internet culture 2
Yeti Ghetto	rap 1
Ying Yang Twins	internet culture
Yndi Halda	psychedelic rock
Yo La Tengo	indie 2
Yoko Ono	rock
Yoni Saffra	pop-punk 1
Yosi Horikawa	indietronica
Yotto	trance
You Blew It!	emo
You Me At Six	indie 1
Young Buck	rap 3
Young Dolph	rap 3
Young Dro	rap 2
Young Fathers	psychedelic rock
Young M.A	rap 1
Young Marble Giants	psychedelic rock
Young Money	rap 1
Young Nudy	rap 3
Young Pappy	rap 3
Young Thug	rap 3
Young Thugga	rap 3
Young the Giant	indie 1
YoungBoy Never Broke Again	rap 3
Younger Brother	indietronica
Youngr	pop 1
Your Old Droog	rap 3
Youth Lagoon	indie 2
Yu-Utsu	indietronica
Yubin	K-pop 1
Yuck	indie 2
Yugo Kanno	otacore
Yuma Yamaguchi	internet culture 2
Yumi Zouma	indie 3
Yuna	indietronica
Yung Bans	rap 3
Yung Chef	rap 2
Yung Gravy	rap 1
Yung Hurn	Europe
Yung Joc	indie 1
Yung Lean	rap 1
Yussef Kamaal	jazz
Yves Tumor	indie 3
Z-Ro	rap 1
ZAYN	pop 2
ZETA	alternative metal
ZHU	edm 1
ZSK	politically engaged
ZZ Top	rock
Zac Brown Band	rock
Zach Hill	electronica
Zach Wright	indie 1
Zack De La Rocha	rock
Zack Hemsey	internet culture
Zager & Evans	rock
Zapp	jazz
Zara Larsson	pop 2
Zatox	hardstyle
Zaytoven	rap 3
Zeal & Ardor	alternative metal
Zeb Newby and The Visibly Upset	indie 1
Zedd	indietronica
Zeds Dead	edm 1
Zella Day	pop 1
Zelooperz	rap 3
Zemfira	Europe
Zero 7	indie 1
Zero Detail	indie 1
Zes	monstercat
Zimtschneckchen	indie 2
Zion I	rap 3
Zion.T	K-pop 1
Zola Jesus	indie 3
Zombie Hyperdrive	synthwave
Zomboy	edm 2
Zomby	edm 1
Zonderling	edm 2
Zu	alternative metal
a crowd of rebellion	metalcore 1
a-ha	internet culture
aaspeaker.com	jazz
alt-J	indie 1
an Unkindness	indie 1
araabMUZIK	edm 1
at Wendys	rap 1
ayokay	pop 1
bLAck pARty	rap 2
batta	otacore
benny blanco	rap 1
berrygood	K-pop 2
billy woods	rap 3
blackbear	pop 1
blessthefall	metalcore 2
blink-182	pop-punk 1
boris smile	pop-punk 1
boy pablo	indie 1
bôa	indietronica
clipping.	rap 1
coldrain	metalcore 1
cupcakKe	pop 2
dBridge	DnB
dEMOTIONAL	metalcore 1
dark cat	monstercat
deadmau5	edm 1
dodie	pop 1
dom champ	spotify
dvsn	rap 1
edIT	indietronica
envy	metalcore 1
ets Amazin!	rap 1
f(x)	K-pop 1
fhána	otacore
flor	pop 3
fox capture plan	J-pop
fromis_9	K-pop 2
fun.	rock
grandson	indietronica
gugudan	K-pop 2
half•alive	rock
hyr	rock
iDubbbz	internet culture 2
iKON	K-pop 2
i_o	edm 2
iamamiwhoami	indietronica
ionnalee	pop 2
j-hope	K-pop 1
jonatan leandoer96	rap 4
josh pan	edm 2
justjaydan	rock
k.d. lang	indie 1
k?d	edm 2
kache	edm 1
kent	Europe
letherette	electronica
letlive.	metalcore 1
little xs for eyes	pop 1
lostprophets	rock
lovelytheband	pop 1
m-flo	J-pop
mabanua	otacore
mansionz	rap 1
mewithoutYou	indie 1
miss A	K-pop 1
moe.	rock
mouse on the keys	psychedelic rock
múm	psychedelic rock
nanobii	monstercat
nothing,nowhere.	rap 2
of Montreal	indie 2
offonoff	K-pop 1
outsideOUTSIDE	internet culture
petal boy	spotify
rathergood.com	internet culture
real1	internet culture 2
serpentwithfeet	indie 3
she	edm 1
sleepmakeswaves	psychedelic rock
slenderbodies	indie 2
slowthai	grime
soupandreas	edm 2
supercell	otacore
t.A.T.u.	rock
the bird and the bee	indie 1
the one and only PPL MVR	indie 1
the pillows	otacore
thegoodnews.	rap 2
tobi lou	rap 1
toe	psychedelic rock
together PANGEA	indie 2
trentemøller	indietronica
tricot	J-pop
whatever the horror	indie 2
will.i.am	rock
xxyyxx	indietronica
zack villere	rap 1
zebrahead	pop-punk 2
µ-Ziq	electronica
Ásgeir	indie 1
Éric Serra	indietronica
Ólafur Arnalds	indie 1
Ørdop Wolkenscheidt	indietronica
✝✝✝ (Crosses)	indie 1
⣎⡇ꉺლ༽இ•̛)ྀ◞ ༎ຶ ༽ৣৢ؞ৢ؞ؖ ꉺლ	indie 3
水田 直志	internet culture 2
物語シリーズ	otacore
이달의 소녀 yyxy	K-pop 1
２８１４	electronica
